GGATGTATTGATTTATCATTCTAT -> GATGTATTGATTTATCATTCTATG
CCACAATTAGTCGTCCGTCCAGCA -> CACAATTAGTCGTCCGTCCAGCAG
TCTTGGATGAATCCCACCAGCGCA -> CTTGGATGAATCCCACCAGCGCAC
GTAAACTCGAGTAATCTTGGTACA -> TAAACTCGAGTAATCTTGGTACAA
GAGCGTGGTGCTTCTTACGCTCGG -> AGCGTGGTGCTTCTTACGCTCGGA
AATCAGACTGCGACCGGTTAGGTA -> ATCAGACTGCGACCGGTTAGGTAA
GGGCGGATTTGGAACTCACTCTTG -> GGCGGATTTGGAACTCACTCTTGG
ACACTGATGCGTGGAGGCCCACTG -> CACTGATGCGTGGAGGCCCACTGT
ATCGTCATAAGCTCTAGTTAGGGC -> TCGTCATAAGCTCTAGTTAGGGCG
CGGAGAAGTAGTCCTCTCACAGGT -> GGAGAAGTAGTCCTCTCACAGGTC
TTTAATCAGCGATACGGACAGGGC -> TTAATCAGCGATACGGACAGGGCG
CTTCTTACGCTCGGAAGAAACTGG -> TTCTTACGCTCGGAAGAAACTGGT
AGCGAGTGATTCGCGATCGCGCGT -> GCGAGTGATTCGCGATCGCGCGTT
TCTGAACGTTGAGGTCTAACTACT -> CTGAACGTTGAGGTCTAACTACTG
CTCCATCTACCGTGTGTCGAGCGT -> TCCATCTACCGTGTGTCGAGCGTG
AGGATGCAGACACGTTCCCTCGAA -> GGATGCAGACACGTTCCCTCGAAA
ATCGCGCGTTGTCTCGCATAACTC -> TCGCGCGTTGTCTCGCATAACTCA
TGGTGCAGCCATGGCTCAGTTGTT -> GGTGCAGCCATGGCTCAGTTGTTT
GAGTTAGACATGCCTCAGAAAACT -> AGTTAGACATGCCTCAGAAAACTC
TGAAACAAAATCTAAGTCATACGC -> GAAACAAAATCTAAGTCATACGCC
TATGACCGACTCGTGTTAAGAAAA -> ATGACCGACTCGTGTTAAGAAAAA
CGGAGGTATTTTTTTGCTTTCCCT -> GGAGGTATTTTTTTGCTTTCCCTC
CGGCCTGTTGGGATGTAAGGAGGT -> GGCCTGTTGGGATGTAAGGAGGTT
GAAGTAGTCCTCTCACAGGTCCAC -> AAGTAGTCCTCTCACAGGTCCACA
CATGAACGGTGGAGTCATTTGTCT -> ATGAACGGTGGAGTCATTTGTCTG
TTACTTCATCTCAGCGAGTGATTC -> TACTTCATCTCAGCGAGTGATTCG
CTTCTAGGAGACAGGGATTGGGTG -> TTCTAGGAGACAGGGATTGGGTGG
CAAAATCTAAGTCATACGCCAAAT -> AAAATCTAAGTCATACGCCAAATC
ACAGATAGACAGTCACTAGATAGA -> CAGATAGACAGTCACTAGATAGAC
CTGTTTAATCAGCGATACGGACAG -> TGTTTAATCAGCGATACGGACAGG
CCAGTGCTCCTAGTACTTGAACAG -> CAGTGCTCCTAGTACTTGAACAGG
AGGTAGTTCTTTAGCGCCTCGATT -> GGTAGTTCTTTAGCGCCTCGATTG
GAACGTTGAGGTCTAACTACTGTG -> AACGTTGAGGTCTAACTACTGTGA
GTGCTCCAGGAATGTGCAGAAAAT -> TGCTCCAGGAATGTGCAGAAAATA
TGGAACTCACTCTTGGATGAATCC -> GGAACTCACTCTTGGATGAATCCC
AGATCTTCTCACAAATCCCCTCTA -> GATCTTCTCACAAATCCCCTCTAT
TATCATTCTATGCGTAGCTACGGG -> ATCATTCTATGCGTAGCTACGGGC
GGATATTCGGAGAAGTAGTCCTCT -> GATATTCGGAGAAGTAGTCCTCTC
ACATCGCGAAGGATTTTTTATCGA -> CATCGCGAAGGATTTTTTATCGAC
AGTCTACCTACGAAGCACAAGATT -> GTCTACCTACGAAGCACAAGATTG
CTTCTCACAAATCCCCTCTATTTA -> TTCTCACAAATCCCCTCTATTTAC
GGTATTTTTTTGCTTTCCCTCCCG -> GTATTTTTTTGCTTTCCCTCCCGT
AACTTCCTTCATCTTGGTGATCCC -> ACTTCCTTCATCTTGGTGATCCCG
GTCTGTCCGGGATTCGGTCCACCT -> TCTGTCCGGGATTCGGTCCACCTA
TCACTCTTGGATGAATCCCACCAG -> CACTCTTGGATGAATCCCACCAGC
CCACACATTTGGATCGACCGATTA -> CACACATTTGGATCGACCGATTAA
CCTCCATCTACCGTGTGTCGAGCG -> CTCCATCTACCGTGTGTCGAGCGT
AGGTAGCCACAGACGCCTATATTT -> GGTAGCCACAGACGCCTATATTTG
TACCGCAACCGACACACACTGATG -> ACCGCAACCGACACACACTGATGC
CAACATCGGATGTATTGATTTATC -> AACATCGGATGTATTGATTTATCA
CAGCGAGTGATTCGCGATCGCGCG -> AGCGAGTGATTCGCGATCGCGCGT
TATATAACTTCCTTCATCTTGGTG -> ATATAACTTCCTTCATCTTGGTGA
TTATCTCGGATATTCGGAGAAGTA -> TATCTCGGATATTCGGAGAAGTAG
TAGACAGTCACTAGATAGACAATT -> AGACAGTCACTAGATAGACAATTT
ATTCGGTCCACCTACCAGGGTCAC -> TTCGGTCCACCTACCAGGGTCACT
GCACAAGATTGGTGCAGCCATGGC -> CACAAGATTGGTGCAGCCATGGCT
TAGCTGGTATGATTCATGATATAA -> AGCTGGTATGATTCATGATATAAT
AGCAATGCTATTCCCATGTTCGTG -> GCAATGCTATTCCCATGTTCGTGG
CAACCGCCGAGTGTGTAGTGGTAG -> AACCGCCGAGTGTGTAGTGGTAGA
AGTCGTCCGTCCAGCAGACCGAAC -> GTCGTCCGTCCAGCAGACCGAACA
TGCGACCGGTTAGGTAATCGAGCA -> GCGACCGGTTAGGTAATCGAGCAA
AGGGCGGATTTGGAACTCACTCTT -> GGGCGGATTTGGAACTCACTCTTG
AGGGGTCTGAACGTTGAGGTCTAA -> GGGGTCTGAACGTTGAGGTCTAAC
CATGAACGATTTTTTCTACAAACT -> ATGAACGATTTTTTCTACAAACTG
AACAGACGGCCTGTTGGGATGTAA -> ACAGACGGCCTGTTGGGATGTAAG
GATTAACAAACTCGGTTAACTGTT -> ATTAACAAACTCGGTTAACTGTTT
GTCGTCCGTCCAGCAGACCGAACA -> TCGTCCGTCCAGCAGACCGAACAG
TTCCCGCGACGGCGCAAGCGTCGT -> TCCCGCGACGGCGCAAGCGTCGTG
TTACCAGCCCCCTCACGCGGAATT -> TACCAGCCCCCTCACGCGGAATTC
ACGATGAAAACAGACGGCCTGTTG -> CGATGAAAACAGACGGCCTGTTGG
GTGACCATGTGAACATGAACGGTG -> TGACCATGTGAACATGAACGGTGG
GATCGACCGATTAACCGCAGATCG -> ATCGACCGATTAACCGCAGATCGT
CTCACGCGGAATTCCTGCAATATT -> TCACGCGGAATTCCTGCAATATTG
GTGGAGTCATTTGTCTGGAACCGC -> TGGAGTCATTTGTCTGGAACCGCG
GGGGTCTGAACGTTGAGGTCTAAC -> GGGTCTGAACGTTGAGGTCTAACT
ACGCGATACGACAGATAGACAGTC -> CGCGATACGACAGATAGACAGTCA
TCCTTCATCTTGGTGATCCCGTAG -> CCTTCATCTTGGTGATCCCGTAGT
AGAAAAACCTGGCGAAGCAGCGGC -> GAAAAACCTGGCGAAGCAGCGGCA
ACAGGGCGGTACTCTATATAACTT -> CAGGGCGGTACTCTATATAACTTC
GTCCAGTGCTCCTAGTACTTGAAC -> TCCAGTGCTCCTAGTACTTGAACA
CGGGGATGAACGTTGTCGTGTAAG -> GGGGATGAACGTTGTCGTGTAAGG
GGGATGAATGATTATGGGTCGTAT -> GGATGAATGATTATGGGTCGTATG
TGTGACCATGTGAACATGAACGGT -> GTGACCATGTGAACATGAACGGTG
TCGCATAACTCACTCGTTACGATG -> CGCATAACTCACTCGTTACGATGA
TACGCCAAATCGATCGTCATAAGC -> ACGCCAAATCGATCGTCATAAGCT
TTGCGTGCAAATGCTAGTACTTAC -> TGCGTGCAAATGCTAGTACTTACA
CTCCGGCCTACATTGCCGGGGTGT -> TCCGGCCTACATTGCCGGGGTGTG
GACCTGAATTAGAGATACTCTGGT -> ACCTGAATTAGAGATACTCTGGTA
AGAAAACTCGGGGCCTCATGGCCG -> GAAAACTCGGGGCCTCATGGCCGG
TATAGGATCGTCGGTAGCTGGTAT -> ATAGGATCGTCGGTAGCTGGTATG
TTATATGGAACACGCATTGCGTGC -> TATATGGAACACGCATTGCGTGCA
ATGTGAACATGAACGGTGGAGTCA -> TGTGAACATGAACGGTGGAGTCAT
CTGCCGGAGGGATCCGGCTGGGGT -> TGCCGGAGGGATCCGGCTGGGGTT
TCAGAAAACTCGGGGCCTCATGGC -> CAGAAAACTCGGGGCCTCATGGCC
GCGTGGAGGCCCACTGTCATGCGG -> CGTGGAGGCCCACTGTCATGCGGG
GTAGCGGGCCTTTATCCCACCACA -> TAGCGGGCCTTTATCCCACCACAG
TTGGATCGACCGATTAACCGCAGA -> TGGATCGACCGATTAACCGCAGAT
TCATCTCAGCGAGTGATTCGCGAT -> CATCTCAGCGAGTGATTCGCGATC
ATTACGTAGGACTACCGCAACCGA -> TTACGTAGGACTACCGCAACCGAC
AATGCTATTCCCATGTTCGTGGAT -> ATGCTATTCCCATGTTCGTGGATA
TTGAACTGGCACATCGCGAAGGAT -> TGAACTGGCACATCGCGAAGGATT
AGTCAAAGCTCTTGATTTATGACC -> GTCAAAGCTCTTGATTTATGACCG
GTGATCCCGTAGTGCACATTACGT -> TGATCCCGTAGTGCACATTACGTA
TTTTATCGACCAATTGTGACCATG -> TTTATCGACCAATTGTGACCATGT
AACGGCTGTCAGCCGCTACTTAGC -> ACGGCTGTCAGCCGCTACTTAGCT
GACGGCCTGTTGGGATGTAAGGAG -> ACGGCCTGTTGGGATGTAAGGAGG
GATTCATGATATAATTCTGCCGCA -> ATTCATGATATAATTCTGCCGCAG
GATACGCCCGGGTAGGGCTACAAA -> ATACGCCCGGGTAGGGCTACAAAT
TGGTGCCGGGGATGAACGTTGTCG -> GGTGCCGGGGATGAACGTTGTCGT
GCGATACGGACAGGGCGGTACTCT -> CGATACGGACAGGGCGGTACTCTA
CACAGACGCCTATATTTGAACTGG -> ACAGACGCCTATATTTGAACTGGC
TGCAGCCATGGCTCAGTTGTTTTA -> GCAGCCATGGCTCAGTTGTTTTAC
GTTTTACTTCATCTCAGCGAGTGA -> TTTTACTTCATCTCAGCGAGTGAT
GATTTTTTATCGACCAATTGTGAC -> ATTTTTTATCGACCAATTGTGACC
AGAGGGGTCTGAACGTTGAGGTCT -> GAGGGGTCTGAACGTTGAGGTCTA
GTTCGTGGATATAACCTAGCCCGT -> TTCGTGGATATAACCTAGCCCGTG
TACAACGATCCGGGATGAATGATT -> ACAACGATCCGGGATGAATGATTA
AGATTGGTGCAGCCATGGCTCAGT -> GATTGGTGCAGCCATGGCTCAGTT
TGTCGAGCGTGGTGCTTCTTACGC -> GTCGAGCGTGGTGCTTCTTACGCT
GCGAAGCAGCGGCATGACTATAGG -> CGAAGCAGCGGCATGACTATAGGA
GAAATTCAACCGCCGAGTGTGTAG -> AAATTCAACCGCCGAGTGTGTAGT
AACTACTGTGACCATTATCTCGGA -> ACTACTGTGACCATTATCTCGGAT
AGACCAGGCGATTAACAAACTCGG -> GACCAGGCGATTAACAAACTCGGT
GGGTCACTCACTGAAGACTCATGA -> GGTCACTCACTGAAGACTCATGAC
GTGCTCCTAGTACTTGAACAGGCA -> TGCTCCTAGTACTTGAACAGGCAA
ACTTCATCTCAGCGAGTGATTCGC -> CTTCATCTCAGCGAGTGATTCGCG
CGGTACTCTATATAACTTCCTTCA -> GGTACTCTATATAACTTCCTTCAT
CGCATTGCGTGCAAATGCTAGTAC -> GCATTGCGTGCAAATGCTAGTACT
GATATAACCTAGCCCGTGGACCCA -> ATATAACCTAGCCCGTGGACCCAT
TACGGGCGATGCTCCGGCCTACAT -> ACGGGCGATGCTCCGGCCTACATT
TGGACCCATGGGCGTCGGATAAAC -> GGACCCATGGGCGTCGGATAAACG
ACGAAGCACAAGATTGGTGCAGCC -> CGAAGCACAAGATTGGTGCAGCCA
AAGATCGAACCCACGCGATACGAC -> AGATCGAACCCACGCGATACGACA
ACACGAAGTCAAAGCTCTTGATTT -> CACGAAGTCAAAGCTCTTGATTTA
TTCTCACAAATCCCCTCTATTTAC -> TCTCACAAATCCCCTCTATTTACC
TGCCGGAGGGATCCGGCTGGGGTT -> GCCGGAGGGATCCGGCTGGGGTTG
CGGATTTGGAACTCACTCTTGGAT -> GGATTTGGAACTCACTCTTGGATG
ACATTGCCGGGGTGTGTCCAGTGC -> CATTGCCGGGGTGTGTCCAGTGCT
AACTGGTCCGTGGGATAGCTGTCA -> ACTGGTCCGTGGGATAGCTGTCAC
GAAAACTCGGGGCCTCATGGCCGG -> AAAACTCGGGGCCTCATGGCCGGT
TCCGGGATGAATGATTATGGGTCG -> CCGGGATGAATGATTATGGGTCGT
TTAGGGCGGATTTGGAACTCACTC -> TAGGGCGGATTTGGAACTCACTCT
CGTCGGATAAACGGCTGTCAGCCG -> GTCGGATAAACGGCTGTCAGCCGC
CATAAGCTCTAGTTAGGGCGGATT -> ATAAGCTCTAGTTAGGGCGGATTT
TTCCCTCGAAACCCACTCAATGAG -> TCCCTCGAAACCCACTCAATGAGT
GCTCGGAAGAAACTGGTCCGTGGG -> CTCGGAAGAAACTGGTCCGTGGGA
AATTCTCGCAGTGCTCCAGGAATG -> ATTCTCGCAGTGCTCCAGGAATGT
ATCTTGGTGATCCCGTAGTGCACA -> TCTTGGTGATCCCGTAGTGCACAT
CGCCTATATTTGAACTGGCACATC -> GCCTATATTTGAACTGGCACATCG
CCGCAACCGACACACACTGATGCG -> CGCAACCGACACACACTGATGCGT
GTGGTGCTTCTTACGCTCGGAAGA -> TGGTGCTTCTTACGCTCGGAAGAA
CGATGAAAACAGACGGCCTGTTGG -> GATGAAAACAGACGGCCTGTTGGG
CAGATCTTCTCACAAATCCCCTCT -> AGATCTTCTCACAAATCCCCTCTA
GTACTCTATATAACTTCCTTCATC -> TACTCTATATAACTTCCTTCATCT
GCGGGCATACTGACACGAAGTCAA -> CGGGCATACTGACACGAAGTCAAA
CACTGTCATGCGGGCATACTGACA -> ACTGTCATGCGGGCATACTGACAC
GTGTTAAGAAAAACCTGGCGAAGC -> TGTTAAGAAAAACCTGGCGAAGCA
GAGGGGTCTGAACGTTGAGGTCTA -> AGGGGTCTGAACGTTGAGGTCTAA
CAGTGCTCCTAGTACTTGAACAGG -> AGTGCTCCTAGTACTTGAACAGGC
AGTACTTACAGGGTTCCCGCGACG -> GTACTTACAGGGTTCCCGCGACGG
GCAATATTGGAGACCTGAATTAGA -> CAATATTGGAGACCTGAATTAGAG
ATAGTCTGTCCGGGATTCGGTCCA -> TAGTCTGTCCGGGATTCGGTCCAC
CCTCCCGTAAATCAGACTGCGACC -> CTCCCGTAAATCAGACTGCGACCG
AATTAGAGATACTCTGGTAACCTC -> ATTAGAGATACTCTGGTAACCTCC
CATCTTGGTGATCCCGTAGTGCAC -> ATCTTGGTGATCCCGTAGTGCACA
ATGTGCAGAAAATACTTCAAGTTC -> TGTGCAGAAAATACTTCAAGTTCC
AGCGCCTCGATTGCAACATCGGAT -> GCGCCTCGATTGCAACATCGGATG
CTCGGATATTCGGAGAAGTAGTCC -> TCGGATATTCGGAGAAGTAGTCCT
TCTATGCGTAGCTACGGGCGATGC -> CTATGCGTAGCTACGGGCGATGCT
CCCTCCCGTAAATCAGACTGCGAC -> CCTCCCGTAAATCAGACTGCGACC
GTGCAAATGCTAGTACTTACAGGG -> TGCAAATGCTAGTACTTACAGGGT
CGACCAATTGTGACCATGTGAACA -> GACCAATTGTGACCATGTGAACAT
GAGACAGGGATTGGGTGGGTGCTC -> AGACAGGGATTGGGTGGGTGCTCA
CTCACTCTTGGATGAATCCCACCA -> TCACTCTTGGATGAATCCCACCAG
CTACAAACTGTCGTCTTCTGACAG -> TACAAACTGTCGTCTTCTGACAGG
ACCTCCATCTACCGTGTGTCGAGC -> CCTCCATCTACCGTGTGTCGAGCG
GGGTGCTCAATCGCCTACATTACG -> GGTGCTCAATCGCCTACATTACGT
AGCTACGGGCGATGCTCCGGCCTA -> GCTACGGGCGATGCTCCGGCCTAC
GATCGAACCCACGCGATACGACAG -> ATCGAACCCACGCGATACGACAGA
GCATACTGACACGAAGTCAAAGCT -> CATACTGACACGAAGTCAAAGCTC
TGTAAGGAGGTTACAACACAGAAA -> GTAAGGAGGTTACAACACAGAAAT
AGGAGACAGGGATTGGGTGGGTGC -> GGAGACAGGGATTGGGTGGGTGCT
GGGAAGTGCCACTCAAGAGGGGTC -> GGAAGTGCCACTCAAGAGGGGTCT
ATTTACCAGCCCCCTCACGCGGAA -> TTTACCAGCCCCCTCACGCGGAAT
TTTACCAGCCCCCTCACGCGGAAT -> TTACCAGCCCCCTCACGCGGAATT
GCCGGAGGGATCCGGCTGGGGTTG -> CCGGAGGGATCCGGCTGGGGTTGA
CTTCCTTCATCTTGGTGATCCCGT -> TTCCTTCATCTTGGTGATCCCGTA
GGATCCGGCTGGGGTTGACCACAA -> GATCCGGCTGGGGTTGACCACAAC
GCCCCCTCACGCGGAATTCCTGCA -> CCCCCTCACGCGGAATTCCTGCAA
CTATTCCCATGTTCGTGGATATAA -> TATTCCCATGTTCGTGGATATAAC
ACAACGAGACCAGGCGATTAACAA -> CAACGAGACCAGGCGATTAACAAA
ATAAGCTCTAGTTAGGGCGGATTT -> TAAGCTCTAGTTAGGGCGGATTTG
GTTGTCTCGCATAACTCACTCGTT -> TTGTCTCGCATAACTCACTCGTTA
CCGTCGTAGGTAGTTCTTTAGCGC -> CGTCGTAGGTAGTTCTTTAGCGCC
GCGCTCGATACGCCCGGGTAGGGC -> CGCTCGATACGCCCGGGTAGGGCT
GCCTATATTTGAACTGGCACATCG -> CCTATATTTGAACTGGCACATCGC
CACGCGATACGACAGATAGACAGT -> ACGCGATACGACAGATAGACAGTC
ACCTGAATTAGAGATACTCTGGTA -> CCTGAATTAGAGATACTCTGGTAA
AGTCCTCTCACAGGTCCACACATT -> GTCCTCTCACAGGTCCACACATTT
TAGACGCCGTCGTAGGTAGTTCTT -> AGACGCCGTCGTAGGTAGTTCTTT
AGCTCTTGATTTATGACCGACTCG -> GCTCTTGATTTATGACCGACTCGT
GCGACGGCGCAAGCGTCGTGGAGA -> CGACGGCGCAAGCGTCGTGGAGAA
GGTTCCCGCGACGGCGCAAGCGTC -> GTTCCCGCGACGGCGCAAGCGTCG
CTTCAAGTTCCACAATTAGTCGTC -> TTCAAGTTCCACAATTAGTCGTCC
TAATCAGCGATACGGACAGGGCGG -> AATCAGCGATACGGACAGGGCGGT
AACCGACACACACTGATGCGTGGA -> ACCGACACACACTGATGCGTGGAG
CAACAACGAGACCAGGCGATTAAC -> AACAACGAGACCAGGCGATTAACA
TAGTACTTGAACAGGCAAAGATCG -> AGTACTTGAACAGGCAAAGATCGA
ATACGGACAGGGCGGTACTCTATA -> TACGGACAGGGCGGTACTCTATAT
ATACTTCAAGTTCCACAATTAGTC -> TACTTCAAGTTCCACAATTAGTCG
TGCAAATGCTAGTACTTACAGGGT -> GCAAATGCTAGTACTTACAGGGTT
GGAACCGCGCCGCCCTTCTAGGAG -> GAACCGCGCCGCCCTTCTAGGAGA
ATGACCGACTCGTGTTAAGAAAAA -> TGACCGACTCGTGTTAAGAAAAAC
ATTGCGTGCAAATGCTAGTACTTA -> TTGCGTGCAAATGCTAGTACTTAC
GATCGTCGGGAATTAACATAGTCT -> ATCGTCGGGAATTAACATAGTCTG
GAATTAGAGATACTCTGGTAACCT -> AATTAGAGATACTCTGGTAACCTC
GGTTGTGATATACCTTTTTTGAAA -> GTTGTGATATACCTTTTTTGAAAC
TGTTCGTGGATATAACCTAGCCCG -> GTTCGTGGATATAACCTAGCCCGT
GGATGAATCCCACCAGCGCACCTT -> GATGAATCCCACCAGCGCACCTTC
TATGGGTCGTATGGAAGGATGCAG -> ATGGGTCGTATGGAAGGATGCAGA
CGGAAGAAACTGGTCCGTGGGATA -> GGAAGAAACTGGTCCGTGGGATAG
ATCAGACTGCGACCGGTTAGGTAA -> TCAGACTGCGACCGGTTAGGTAAT
AAGCAGCGGCATGACTATAGGATC -> AGCAGCGGCATGACTATAGGATCG
AGAAGTAGTCCTCTCACAGGTCCA -> GAAGTAGTCCTCTCACAGGTCCAC
GTTACAACACAGAAATTCAACCGC -> TTACAACACAGAAATTCAACCGCC
GCAAAGATCGAACCCACGCGATAC -> CAAAGATCGAACCCACGCGATACG
GGGATGAACGTTGTCGTGTAAGGT -> GGATGAACGTTGTCGTGTAAGGTA
TCCCACCAGCGCACCTTCTGCTGC -> CCCACCAGCGCACCTTCTGCTGCC
GCTCAATCGCCTACATTACGTAGG -> CTCAATCGCCTACATTACGTAGGA
TGAACGGTGGAGTCATTTGTCTGG -> GAACGGTGGAGTCATTTGTCTGGA
TGAAGAAGACAATTCTCGCAGTGC -> GAAGAAGACAATTCTCGCAGTGCT
TTTTTTGAAACAAAATCTAAGTCA -> TTTTTGAAACAAAATCTAAGTCAT
CTCTGGTAACCTCCATCTACCGTG -> TCTGGTAACCTCCATCTACCGTGT
AAGGATTTTTTATCGACCAATTGT -> AGGATTTTTTATCGACCAATTGTG
GTCATGCGGGCATACTGACACGAA -> TCATGCGGGCATACTGACACGAAG
CTCAATGAGTCTACCTACGAAGCA -> TCAATGAGTCTACCTACGAAGCAC
ATCGTCGGTAGCTGGTATGATTCA -> TCGTCGGTAGCTGGTATGATTCAT
GCGGAATTCCTGCAATATTGGAGA -> CGGAATTCCTGCAATATTGGAGAC
ACAGGCGCTCGATACGCCCGGGTA -> CAGGCGCTCGATACGCCCGGGTAG
CAACGAGACCAGGCGATTAACAAA -> AACGAGACCAGGCGATTAACAAAC
AGGTTAGGTCATGGCTGGTGCCGG -> GGTTAGGTCATGGCTGGTGCCGGG
CTAGCCCGTGGACCCATGGGCGTC -> TAGCCCGTGGACCCATGGGCGTCG
ACCGACACACACTGATGCGTGGAG -> CCGACACACACTGATGCGTGGAGG
AGCAGACCGAACAGCAGATCTTCT -> GCAGACCGAACAGCAGATCTTCTC
ACTGGCACATCGCGAAGGATTTTT -> CTGGCACATCGCGAAGGATTTTTT
CACAACCCCTGCCGGTGATTGCTA -> ACAACCCCTGCCGGTGATTGCTAA
GTGTGTCCAGTGCTCCTAGTACTT -> TGTGTCCAGTGCTCCTAGTACTTG
CTCACTCGTTACGATGAAAACAGA -> TCACTCGTTACGATGAAAACAGAC
GGATCGACCGATTAACCGCAGATC -> GATCGACCGATTAACCGCAGATCG
ATAACTTCCTTCATCTTGGTGATC -> TAACTTCCTTCATCTTGGTGATCC
CCGGGATGAATGATTATGGGTCGT -> CGGGATGAATGATTATGGGTCGTA
ACTATAGGATCGTCGGTAGCTGGT -> CTATAGGATCGTCGGTAGCTGGTA
CCATCTACCGTGTGTCGAGCGTGG -> CATCTACCGTGTGTCGAGCGTGGT
CACGTTCCCTCGAAACCCACTCAA -> ACGTTCCCTCGAAACCCACTCAAT
AACCTGGCGAAGCAGCGGCATGAC -> ACCTGGCGAAGCAGCGGCATGACT
TCACGGTTGTGATATACCTTTTTT -> CACGGTTGTGATATACCTTTTTTG
GCGATTAACAAACTCGGTTAACTG -> CGATTAACAAACTCGGTTAACTGT
TAGTACTTACAGGGTTCCCGCGAC -> AGTACTTACAGGGTTCCCGCGACG
AGACGCCGTCGTAGGTAGTTCTTT -> GACGCCGTCGTAGGTAGTTCTTTA
ACAAACTGTCGTCTTCTGACAGGT -> CAAACTGTCGTCTTCTGACAGGTT
CAATCGCCTACATTACGTAGGACT -> AATCGCCTACATTACGTAGGACTA
GGCGGATTTGGAACTCACTCTTGG -> GCGGATTTGGAACTCACTCTTGGA
TGTGTCCAGTGCTCCTAGTACTTG -> GTGTCCAGTGCTCCTAGTACTTGA
GGTAGGGCTACAAATGGTTTTGAT -> GTAGGGCTACAAATGGTTTTGATT
CTTACGCTCGGAAGAAACTGGTCC -> TTACGCTCGGAAGAAACTGGTCCG
TACGAAGCACAAGATTGGTGCAGC -> ACGAAGCACAAGATTGGTGCAGCC
TCCAGCAGACCGAACAGCAGATCT -> CCAGCAGACCGAACAGCAGATCTT
AGACATGCCTCAGAAAACTCGGGG -> GACATGCCTCAGAAAACTCGGGGC
TTCCTGCAATATTGGAGACCTGAA -> TCCTGCAATATTGGAGACCTGAAT
TGGGAAGTGCCACTCAAGAGGGGT -> GGGAAGTGCCACTCAAGAGGGGTC
AAATCCCCTCTATTTACCAGCCCC -> AATCCCCTCTATTTACCAGCCCCC
TCATGACGGAGGTATTTTTTTGCT -> CATGACGGAGGTATTTTTTTGCTT
GTTAGGTAATCGAGCAATGCTATT -> TTAGGTAATCGAGCAATGCTATTC
TTGAAACAAAATCTAAGTCATACG -> TGAAACAAAATCTAAGTCATACGC
ACATAGTCTGTCCGGGATTCGGTC -> CATAGTCTGTCCGGGATTCGGTCC
CCACCACAGGCGCTCGATACGCCC -> CACCACAGGCGCTCGATACGCCCG
GGGTCTGAACGTTGAGGTCTAACT -> GGTCTGAACGTTGAGGTCTAACTA
CTGAACGTTGAGGTCTAACTACTG -> TGAACGTTGAGGTCTAACTACTGT
TGGTAACCTCCATCTACCGTGTGT -> GGTAACCTCCATCTACCGTGTGTC
AAGCTCTTGATTTATGACCGACTC -> AGCTCTTGATTTATGACCGACTCG
CGCCGTCGTAGGTAGTTCTTTAGC -> GCCGTCGTAGGTAGTTCTTTAGCG
GGAAGGATGCAGACACGTTCCCTC -> GAAGGATGCAGACACGTTCCCTCG
TATAACTTCCTTCATCTTGGTGAT -> ATAACTTCCTTCATCTTGGTGATC
CTGGGGTTGACCACAACCCCTGCC -> TGGGGTTGACCACAACCCCTGCCG
GTCGGATAAACGGCTGTCAGCCGC -> TCGGATAAACGGCTGTCAGCCGCT
TCGTGTTAAGAAAAACCTGGCGAA -> CGTGTTAAGAAAAACCTGGCGAAG
CTGGCACATCGCGAAGGATTTTTT -> TGGCACATCGCGAAGGATTTTTTA
GAGACCAGGCGATTAACAAACTCG -> AGACCAGGCGATTAACAAACTCGG
CGAGCAATGCTATTCCCATGTTCG -> GAGCAATGCTATTCCCATGTTCGT
GGGAATTAACATAGTCTGTCCGGG -> GGAATTAACATAGTCTGTCCGGGA
CCTCGAAACCCACTCAATGAGTCT -> CTCGAAACCCACTCAATGAGTCTA
ACCCACTCAATGAGTCTACCTACG -> CCCACTCAATGAGTCTACCTACGA
GCTACGGGCGATGCTCCGGCCTAC -> CTACGGGCGATGCTCCGGCCTACA
AAAACTCGGGGCCTCATGGCCGGT -> AAACTCGGGGCCTCATGGCCGGTA
GTAAGGTAGCCACAGACGCCTATA -> TAAGGTAGCCACAGACGCCTATAT
CTCTATTTACCAGCCCCCTCACGC -> TCTATTTACCAGCCCCCTCACGCG
TCGTATGGAAGGATGCAGACACGT -> CGTATGGAAGGATGCAGACACGTT
GATATTCGGAGAAGTAGTCCTCTC -> ATATTCGGAGAAGTAGTCCTCTCA
CAGCGATACGGACAGGGCGGTACT -> AGCGATACGGACAGGGCGGTACTC
CCTCTCACAGGTCCACACATTTGG -> CTCTCACAGGTCCACACATTTGGA
TTAAGAAAAACCTGGCGAAGCAGC -> TAAGAAAAACCTGGCGAAGCAGCG
ATATTCGGAGAAGTAGTCCTCTCA -> TATTCGGAGAAGTAGTCCTCTCAC
GGTAGTTCTTTAGCGCCTCGATTG -> GTAGTTCTTTAGCGCCTCGATTGC
AGAAACATGAACGATTTTTTCTAC -> GAAACATGAACGATTTTTTCTACA
GGTCCACACATTTGGATCGACCGA -> GTCCACACATTTGGATCGACCGAT
ACCACAACCCCTGCCGGTGATTGC -> CCACAACCCCTGCCGGTGATTGCT
TACGCCCGGGTAGGGCTACAAATG -> ACGCCCGGGTAGGGCTACAAATGG
ACAACGATCCGGGATGAATGATTA -> CAACGATCCGGGATGAATGATTAT
GTCTTCTGACAGGTTAGGTCATGG -> TCTTCTGACAGGTTAGGTCATGGC
ATTTATCATTCTATGCGTAGCTAC -> TTTATCATTCTATGCGTAGCTACG
GTGACCATTATCTCGGATATTCGG -> TGACCATTATCTCGGATATTCGGA
TACGACCTCCTAGATCTGAACAAC -> ACGACCTCCTAGATCTGAACAACA
TGGAAGGATGCAGACACGTTCCCT -> GGAAGGATGCAGACACGTTCCCTC
GATCCCGTAGTGCACATTACGTAA -> ATCCCGTAGTGCACATTACGTAAA
GGAACACGCATTGCGTGCAAATGC -> GAACACGCATTGCGTGCAAATGCT
ATATACCTTTTTTGAAACAAAATC -> TATACCTTTTTTGAAACAAAATCT
ACTACTGTGACCATTATCTCGGAT -> CTACTGTGACCATTATCTCGGATA
GCTAGTACTTACAGGGTTCCCGCG -> CTAGTACTTACAGGGTTCCCGCGA
GACCCTGAAGAAGACAATTCTCGC -> ACCCTGAAGAAGACAATTCTCGCA
TAGGTAATCGAGCAATGCTATTCC -> AGGTAATCGAGCAATGCTATTCCC
CAACGATCCGGGATGAATGATTAT -> AACGATCCGGGATGAATGATTATG
TGTAGTGGTAGAGGAGTTAGACAT -> GTAGTGGTAGAGGAGTTAGACATG
CGCGAAGGATTTTTTATCGACCAA -> GCGAAGGATTTTTTATCGACCAAT
AACTCGGGGCCTCATGGCCGGTAG -> ACTCGGGGCCTCATGGCCGGTAGC
ACACGCATTGCGTGCAAATGCTAG -> CACGCATTGCGTGCAAATGCTAGT
TCCCATGTTCGTGGATATAACCTA -> CCCATGTTCGTGGATATAACCTAG
TCGAGCAATGCTATTCCCATGTTC -> CGAGCAATGCTATTCCCATGTTCG
TACTGCCGGAGGGATCCGGCTGGG -> ACTGCCGGAGGGATCCGGCTGGGG
TCCCGCGACGGCGCAAGCGTCGTG -> CCCGCGACGGCGCAAGCGTCGTGG
CGAACAGCAGATCTTCTCACAAAT -> GAACAGCAGATCTTCTCACAAATC
TGGATATAACCTAGCCCGTGGACC -> GGATATAACCTAGCCCGTGGACCC
AACCCACTCAATGAGTCTACCTAC -> ACCCACTCAATGAGTCTACCTACG
TAGTCCTCTCACAGGTCCACACAT -> AGTCCTCTCACAGGTCCACACATT
TATTGATTTATCATTCTATGCGTA -> ATTGATTTATCATTCTATGCGTAG
GGCCGGTAGCGGGCCTTTATCCCA -> GCCGGTAGCGGGCCTTTATCCCAC
TGTGTAGTGGTAGAGGAGTTAGAC -> GTGTAGTGGTAGAGGAGTTAGACA
TTTGCTTTCCCTCCCGTAAATCAG -> TTGCTTTCCCTCCCGTAAATCAGA
AGTTAGACATGCCTCAGAAAACTC -> GTTAGACATGCCTCAGAAAACTCG
AAGTCATACGCCAAATCGATCGTC -> AGTCATACGCCAAATCGATCGTCA
CACAATTAGTCGTCCGTCCAGCAG -> ACAATTAGTCGTCCGTCCAGCAGA
CCCGTAAATCAGACTGCGACCGGT -> CCGTAAATCAGACTGCGACCGGTT
ATCTGAACAACAACGAGACCAGGC -> TCTGAACAACAACGAGACCAGGCG
CGTCATAAGCTCTAGTTAGGGCGG -> GTCATAAGCTCTAGTTAGGGCGGA
CCTACATTACGTAGGACTACCGCA -> CTACATTACGTAGGACTACCGCAA
CCACAGGCGCTCGATACGCCCGGG -> CACAGGCGCTCGATACGCCCGGGT
CCGGTAGCGGGCCTTTATCCCACC -> CGGTAGCGGGCCTTTATCCCACCA
TATGGAACACGCATTGCGTGCAAA -> ATGGAACACGCATTGCGTGCAAAT
GGAGAAACATGAACGATTTTTTCT -> GAGAAACATGAACGATTTTTTCTA
TATACCTTTTTTGAAACAAAATCT -> ATACCTTTTTTGAAACAAAATCTA
CGATCGCGCGTTGTCTCGCATAAC -> GATCGCGCGTTGTCTCGCATAACT
ATGGCCGGTAGCGGGCCTTTATCC -> TGGCCGGTAGCGGGCCTTTATCCC
TCCAGGAATGTGCAGAAAATACTT -> CCAGGAATGTGCAGAAAATACTTC
TAGCCACAGACGCCTATATTTGAA -> AGCCACAGACGCCTATATTTGAAC
TGGATGAATCCCACCAGCGCACCT -> GGATGAATCCCACCAGCGCACCTT
CACCACAGGCGCTCGATACGCCCG -> ACCACAGGCGCTCGATACGCCCGG
ACAGGTCCACACATTTGGATCGAC -> CAGGTCCACACATTTGGATCGACC
CCTGCAATATTGGAGACCTGAATT -> CTGCAATATTGGAGACCTGAATTA
ATTGCTAAGACCCTGAAGAAGACA -> TTGCTAAGACCCTGAAGAAGACAA
CAGGAATGTGCAGAAAATACTTCA -> AGGAATGTGCAGAAAATACTTCAA
TCACAAATCCCCTCTATTTACCAG -> CACAAATCCCCTCTATTTACCAGC
AGACAATTCTCGCAGTGCTCCAGG -> GACAATTCTCGCAGTGCTCCAGGA
GCGACCGGTTAGGTAATCGAGCAA -> CGACCGGTTAGGTAATCGAGCAAT
TGGCCGGTAGCGGGCCTTTATCCC -> GGCCGGTAGCGGGCCTTTATCCCA
GTAGTCCTCTCACAGGTCCACACA -> TAGTCCTCTCACAGGTCCACACAT
GGCTACAAATGGTTTTGATTCACT -> GCTACAAATGGTTTTGATTCACTG
GATTGGTGCAGCCATGGCTCAGTT -> ATTGGTGCAGCCATGGCTCAGTTG
GTATGGAAGGATGCAGACACGTTC -> TATGGAAGGATGCAGACACGTTCC
TCGCGAAGGATTTTTTATCGACCA -> CGCGAAGGATTTTTTATCGACCAA
AACGATCCGGGATGAATGATTATG -> ACGATCCGGGATGAATGATTATGG
AGTCACTAGATAGACAATTTATAC -> GTCACTAGATAGACAATTTATACG
GTCATACGCCAAATCGATCGTCAT -> TCATACGCCAAATCGATCGTCATA
TCTCGGATATTCGGAGAAGTAGTC -> CTCGGATATTCGGAGAAGTAGTCC
TGGTACAACGATCCGGGATGAATG -> GGTACAACGATCCGGGATGAATGA
TGCGTGGAGGCCCACTGTCATGCG -> GCGTGGAGGCCCACTGTCATGCGG
CAGGGTCACTCACTGAAGACTCAT -> AGGGTCACTCACTGAAGACTCATG
TGGAGAAACATGAACGATTTTTTC -> GGAGAAACATGAACGATTTTTTCT
CAATATTGGAGACCTGAATTAGAG -> AATATTGGAGACCTGAATTAGAGA
CGTAGTGCACATTACGTAAACTCG -> GTAGTGCACATTACGTAAACTCGA
GCAGATCTTCTCACAAATCCCCTC -> CAGATCTTCTCACAAATCCCCTCT
TCGAAACCCACTCAATGAGTCTAC -> CGAAACCCACTCAATGAGTCTACC
TCCTAGTACTTGAACAGGCAAAGA -> CCTAGTACTTGAACAGGCAAAGAT
GGCACATCGCGAAGGATTTTTTAT -> GCACATCGCGAAGGATTTTTTATC
GCCGGGGTGTGTCCAGTGCTCCTA -> CCGGGGTGTGTCCAGTGCTCCTAG
TGATCCCGTAGTGCACATTACGTA -> GATCCCGTAGTGCACATTACGTAA
TGCAATATTGGAGACCTGAATTAG -> GCAATATTGGAGACCTGAATTAGA
CTACGGGCGATGCTCCGGCCTACA -> TACGGGCGATGCTCCGGCCTACAT
CAATTGTGACCATGTGAACATGAA -> AATTGTGACCATGTGAACATGAAC
CTCAAGAGGGGTCTGAACGTTGAG -> TCAAGAGGGGTCTGAACGTTGAGG
ATTTTTTTGCTTTCCCTCCCGTAA -> TTTTTTTGCTTTCCCTCCCGTAAA
TTGCCGGGGTGTGTCCAGTGCTCC -> TGCCGGGGTGTGTCCAGTGCTCCT
ATTAACATAGTCTGTCCGGGATTC -> TTAACATAGTCTGTCCGGGATTCG
TTAGACATGCCTCAGAAAACTCGG -> TAGACATGCCTCAGAAAACTCGGG
CGATTTTTTCTACAAACTGTCGTC -> GATTTTTTCTACAAACTGTCGTCT
AGAGGAGTTAGACATGCCTCAGAA -> GAGGAGTTAGACATGCCTCAGAAA
CTCGAGTAATCTTGGTACAACGAT -> TCGAGTAATCTTGGTACAACGATC
GGCTCAGTTGTTTTACTTCATCTC -> GCTCAGTTGTTTTACTTCATCTCA
CTCGGGGCCTCATGGCCGGTAGCG -> TCGGGGCCTCATGGCCGGTAGCGG
ATCAGCGATACGGACAGGGCGGTA -> TCAGCGATACGGACAGGGCGGTAC
GAGATACTCTGGTAACCTCCATCT -> AGATACTCTGGTAACCTCCATCTA
GGCATACTGACACGAAGTCAAAGC -> GCATACTGACACGAAGTCAAAGCT
GGGATCCGGCTGGGGTTGACCACA -> GGATCCGGCTGGGGTTGACCACAA
CAAAGATCGAACCCACGCGATACG -> AAAGATCGAACCCACGCGATACGA
AACTGGCACATCGCGAAGGATTTT -> ACTGGCACATCGCGAAGGATTTTT
CGGTTGTGATATACCTTTTTTGAA -> GGTTGTGATATACCTTTTTTGAAA
TTGCTAAGACCCTGAAGAAGACAA -> TGCTAAGACCCTGAAGAAGACAAT
GCTTCTTACGCTCGGAAGAAACTG -> CTTCTTACGCTCGGAAGAAACTGG
ATAGCTGTCACGGTTGTGATATAC -> TAGCTGTCACGGTTGTGATATACC
GTCTAACTACTGTGACCATTATCT -> TCTAACTACTGTGACCATTATCTC
ATGCGTGGAGGCCCACTGTCATGC -> TGCGTGGAGGCCCACTGTCATGCG
TCAACCGCCGAGTGTGTAGTGGTA -> CAACCGCCGAGTGTGTAGTGGTAG
CAGGGTTCCCGCGACGGCGCAAGC -> AGGGTTCCCGCGACGGCGCAAGCG
GAAGTCAAAGCTCTTGATTTATGA -> AAGTCAAAGCTCTTGATTTATGAC
TTTGAACTGGCACATCGCGAAGGA -> TTGAACTGGCACATCGCGAAGGAT
ATGAACGTTGTCGTGTAAGGTAGC -> TGAACGTTGTCGTGTAAGGTAGCC
TCCGTCCAGCAGACCGAACAGCAG -> CCGTCCAGCAGACCGAACAGCAGA
CCCATGGGCGTCGGATAAACGGCT -> CCATGGGCGTCGGATAAACGGCTG
TGGTGCTTCTTACGCTCGGAAGAA -> GGTGCTTCTTACGCTCGGAAGAAA
TTTTACTGCCGGAGGGATCCGGCT -> TTTACTGCCGGAGGGATCCGGCTG
CCGACACACACTGATGCGTGGAGG -> CGACACACACTGATGCGTGGAGGC
TCTCGCAGTGCTCCAGGAATGTGC -> CTCGCAGTGCTCCAGGAATGTGCA
CGCCTCGATTGCAACATCGGATGT -> GCCTCGATTGCAACATCGGATGTA
ATCTCAGCGAGTGATTCGCGATCG -> TCTCAGCGAGTGATTCGCGATCGC
AATGGTTTTGATTCACTGTGGGAA -> ATGGTTTTGATTCACTGTGGGAAG
TACATTACGTAGGACTACCGCAAC -> ACATTACGTAGGACTACCGCAACC
AAGAAAAACCTGGCGAAGCAGCGG -> AGAAAAACCTGGCGAAGCAGCGGC
AGAAGACAATTCTCGCAGTGCTCC -> GAAGACAATTCTCGCAGTGCTCCA
CTAGATAGACAATTTATACGACCT -> TAGATAGACAATTTATACGACCTC
TACAAATGGTTTTGATTCACTGTG -> ACAAATGGTTTTGATTCACTGTGG
AGGAGTTAGACATGCCTCAGAAAA -> GGAGTTAGACATGCCTCAGAAAAC
CCCGTAGTGCACATTACGTAAACT -> CCGTAGTGCACATTACGTAAACTC
AGGGCTACAAATGGTTTTGATTCA -> GGGCTACAAATGGTTTTGATTCAC
AAATTCAACCGCCGAGTGTGTAGT -> AATTCAACCGCCGAGTGTGTAGTG
TTCAACCGCCGAGTGTGTAGTGGT -> TCAACCGCCGAGTGTGTAGTGGTA
TACAACACAGAAATTCAACCGCCG -> ACAACACAGAAATTCAACCGCCGA
TGACCACAACCCCTGCCGGTGATT -> GACCACAACCCCTGCCGGTGATTG
CCAGCAGACCGAACAGCAGATCTT -> CAGCAGACCGAACAGCAGATCTTC
ACCTACCAGGGTCACTCACTGAAG -> CCTACCAGGGTCACTCACTGAAGA
GGGGCCTCATGGCCGGTAGCGGGC -> GGGCCTCATGGCCGGTAGCGGGCC
TTAACTGTTTAATCAGCGATACGG -> TAACTGTTTAATCAGCGATACGGA
TGGTGATCCCGTAGTGCACATTAC -> GGTGATCCCGTAGTGCACATTACG
TTACAACACAGAAATTCAACCGCC -> TACAACACAGAAATTCAACCGCCG
AATGATTATGGGTCGTATGGAAGG -> ATGATTATGGGTCGTATGGAAGGA
GTCCTCTCACAGGTCCACACATTT -> TCCTCTCACAGGTCCACACATTTG
ACAAAATCTAAGTCATACGCCAAA -> CAAAATCTAAGTCATACGCCAAAT
TCGGTAGCTGGTATGATTCATGAT -> CGGTAGCTGGTATGATTCATGATA
CACTGAAGACTCATGACGGAGGTA -> ACTGAAGACTCATGACGGAGGTAT
TTACGTAAACTCGAGTAATCTTGG -> TACGTAAACTCGAGTAATCTTGGT
AGACTCATGACGGAGGTATTTTTT -> GACTCATGACGGAGGTATTTTTTT
GTCGTGGAGAAACATGAACGATTT -> TCGTGGAGAAACATGAACGATTTT
TCAGCCGCTACTTAGCTTTTTACT -> CAGCCGCTACTTAGCTTTTTACTG
CGATACGACAGATAGACAGTCACT -> GATACGACAGATAGACAGTCACTA
CACGAAGTCAAAGCTCTTGATTTA -> ACGAAGTCAAAGCTCTTGATTTAT
TTTTTTATCGACCAATTGTGACCA -> TTTTTATCGACCAATTGTGACCAT
GTTAGGGCGGATTTGGAACTCACT -> TTAGGGCGGATTTGGAACTCACTC
GTCAAAGCTCTTGATTTATGACCG -> TCAAAGCTCTTGATTTATGACCGA
GGGCGATGCTCCGGCCTACATTGC -> GGCGATGCTCCGGCCTACATTGCC
TCGACCGATTAACCGCAGATCGTC -> CGACCGATTAACCGCAGATCGTCG
TCGCGCGTTGTCTCGCATAACTCA -> CGCGCGTTGTCTCGCATAACTCAC
ATTAACAAACTCGGTTAACTGTTT -> TTAACAAACTCGGTTAACTGTTTA
TCCCTCCCGTAAATCAGACTGCGA -> CCCTCCCGTAAATCAGACTGCGAC
CATACGCCAAATCGATCGTCATAA -> ATACGCCAAATCGATCGTCATAAG
AGATAGACAGTCACTAGATAGACA -> GATAGACAGTCACTAGATAGACAA
GATTTGGAACTCACTCTTGGATGA -> ATTTGGAACTCACTCTTGGATGAA
TCTTACGCTCGGAAGAAACTGGTC -> CTTACGCTCGGAAGAAACTGGTCC
GCCTCATGGCCGGTAGCGGGCCTT -> CCTCATGGCCGGTAGCGGGCCTTT
GGAAGTGCCACTCAAGAGGGGTCT -> GAAGTGCCACTCAAGAGGGGTCTG
CGTCTTCTGACAGGTTAGGTCATG -> GTCTTCTGACAGGTTAGGTCATGG
CTAGTACTTGAACAGGCAAAGATC -> TAGTACTTGAACAGGCAAAGATCG
GGTGCCGGGGATGAACGTTGTCGT -> GTGCCGGGGATGAACGTTGTCGTG
ATCTAAGTCATACGCCAAATCGAT -> TCTAAGTCATACGCCAAATCGATC
ACAAATCCCCTCTATTTACCAGCC -> CAAATCCCCTCTATTTACCAGCCC
GGTCGTATGGAAGGATGCAGACAC -> GTCGTATGGAAGGATGCAGACACG
TGAACGTTGAGGTCTAACTACTGT -> GAACGTTGAGGTCTAACTACTGTG
GTACAACGATCCGGGATGAATGAT -> TACAACGATCCGGGATGAATGATT
CAGAAATTCAACCGCCGAGTGTGT -> AGAAATTCAACCGCCGAGTGTGTA
GAAGACAATTCTCGCAGTGCTCCA -> AAGACAATTCTCGCAGTGCTCCAG
CGCGATACGACAGATAGACAGTCA -> GCGATACGACAGATAGACAGTCAC
AAACTCGGTTAACTGTTTAATCAG -> AACTCGGTTAACTGTTTAATCAGC
ACAATTCTCGCAGTGCTCCAGGAA -> CAATTCTCGCAGTGCTCCAGGAAT
GAGGAGTTAGACATGCCTCAGAAA -> AGGAGTTAGACATGCCTCAGAAAA
CGTGGAGGCCCACTGTCATGCGGG -> GTGGAGGCCCACTGTCATGCGGGC
ATTGTGACCATGTGAACATGAACG -> TTGTGACCATGTGAACATGAACGG
GTGTAAGGTAGCCACAGACGCCTA -> TGTAAGGTAGCCACAGACGCCTAT
GACACACACTGATGCGTGGAGGCC -> ACACACACTGATGCGTGGAGGCCC
TGCTTCTTACGCTCGGAAGAAACT -> GCTTCTTACGCTCGGAAGAAACTG
GCTGGTATGATTCATGATATAATT -> CTGGTATGATTCATGATATAATTC
AGCGATACGGACAGGGCGGTACTC -> GCGATACGGACAGGGCGGTACTCT
TTTTTTCTACAAACTGTCGTCTTC -> TTTTTCTACAAACTGTCGTCTTCT
CGACGGCGCAAGCGTCGTGGAGAA -> GACGGCGCAAGCGTCGTGGAGAAA
TACCTTTTTTGAAACAAAATCTAA -> ACCTTTTTTGAAACAAAATCTAAG
TGAGGTCTAACTACTGTGACCATT -> GAGGTCTAACTACTGTGACCATTA
TTCATCTCAGCGAGTGATTCGCGA -> TCATCTCAGCGAGTGATTCGCGAT
TATATGGAACACGCATTGCGTGCA -> ATATGGAACACGCATTGCGTGCAA
CTCATGGCCGGTAGCGGGCCTTTA -> TCATGGCCGGTAGCGGGCCTTTAT
CGTAAATCAGACTGCGACCGGTTA -> GTAAATCAGACTGCGACCGGTTAG
CTTGAACAGGCAAAGATCGAACCC -> TTGAACAGGCAAAGATCGAACCCA
ATCCCACCAGCGCACCTTCTGCTG -> TCCCACCAGCGCACCTTCTGCTGC
CATGGGCGTCGGATAAACGGCTGT -> ATGGGCGTCGGATAAACGGCTGTC
TGTCATGCGGGCATACTGACACGA -> GTCATGCGGGCATACTGACACGAA
AACTCACTCTTGGATGAATCCCAC -> ACTCACTCTTGGATGAATCCCACC
CTACATTGCCGGGGTGTGTCCAGT -> TACATTGCCGGGGTGTGTCCAGTG
CCAATTGTGACCATGTGAACATGA -> CAATTGTGACCATGTGAACATGAA
CGGTTAACTGTTTAATCAGCGATA -> GGTTAACTGTTTAATCAGCGATAC
AACATCGGATGTATTGATTTATCA -> ACATCGGATGTATTGATTTATCAT
CGGATGTATTGATTTATCATTCTA -> GGATGTATTGATTTATCATTCTAT
GGCCTTTATCCCACCACAGGCGCT -> GCCTTTATCCCACCACAGGCGCTC
ACCCATGGGCGTCGGATAAACGGC -> CCCATGGGCGTCGGATAAACGGCT
CGGATAAACGGCTGTCAGCCGCTA -> GGATAAACGGCTGTCAGCCGCTAC
ACAAATGGTTTTGATTCACTGTGG -> CAAATGGTTTTGATTCACTGTGGG
TCAAGAGGGGTCTGAACGTTGAGG -> CAAGAGGGGTCTGAACGTTGAGGT
CATGATATAATTCTGCCGCAGAAA -> ATGATATAATTCTGCCGCAGAAAG
GAACAGCAGATCTTCTCACAAATC -> AACAGCAGATCTTCTCACAAATCC
ACATCGGATGTATTGATTTATCAT -> CATCGGATGTATTGATTTATCATT
GTTACGATGAAAACAGACGGCCTG -> TTACGATGAAAACAGACGGCCTGT
ATTGCCGGGGTGTGTCCAGTGCTC -> TTGCCGGGGTGTGTCCAGTGCTCC
CGGTAGCGGGCCTTTATCCCACCA -> GGTAGCGGGCCTTTATCCCACCAC
TCACTGTGGGAAGTGCCACTCAAG -> CACTGTGGGAAGTGCCACTCAAGA
TGAATCCCACCAGCGCACCTTCTG -> GAATCCCACCAGCGCACCTTCTGC
AGGCGCTCGATACGCCCGGGTAGG -> GGCGCTCGATACGCCCGGGTAGGG
ACTTAGCTTTTTACTGCCGGAGGG -> CTTAGCTTTTTACTGCCGGAGGGA
GATTGGGTGGGTGCTCAATCGCCT -> ATTGGGTGGGTGCTCAATCGCCTA
ACTACCGCAACCGACACACACTGA -> CTACCGCAACCGACACACACTGAT
TCGACCAATTGTGACCATGTGAAC -> CGACCAATTGTGACCATGTGAACA
ACTCACTGAAGACTCATGACGGAG -> CTCACTGAAGACTCATGACGGAGG
TTATGGGTCGTATGGAAGGATGCA -> TATGGGTCGTATGGAAGGATGCAG
CCTACATTGCCGGGGTGTGTCCAG -> CTACATTGCCGGGGTGTGTCCAGT
GCCTTTATCCCACCACAGGCGCTC -> CCTTTATCCCACCACAGGCGCTCG
ACTCAAGAGGGGTCTGAACGTTGA -> CTCAAGAGGGGTCTGAACGTTGAG
AGCTTTTTACTGCCGGAGGGATCC -> GCTTTTTACTGCCGGAGGGATCCG
TACCAGCCCCCTCACGCGGAATTC -> ACCAGCCCCCTCACGCGGAATTCC
GTTGTTTTACTTCATCTCAGCGAG -> TTGTTTTACTTCATCTCAGCGAGT
CTCGATACGCCCGGGTAGGGCTAC -> TCGATACGCCCGGGTAGGGCTACA
CATGACTATAGGATCGTCGGTAGC -> ATGACTATAGGATCGTCGGTAGCT
GATACGACAGATAGACAGTCACTA -> ATACGACAGATAGACAGTCACTAG
TCCTGCAATATTGGAGACCTGAAT -> CCTGCAATATTGGAGACCTGAATT
CCGATTAACCGCAGATCGTCGGGA -> CGATTAACCGCAGATCGTCGGGAA
TTTTGAAACAAAATCTAAGTCATA -> TTTGAAACAAAATCTAAGTCATAC
ATCCGGCTGGGGTTGACCACAACC -> TCCGGCTGGGGTTGACCACAACCC
GTGGTAGAGGAGTTAGACATGCCT -> TGGTAGAGGAGTTAGACATGCCTC
GGATTCGGTCCACCTACCAGGGTC -> GATTCGGTCCACCTACCAGGGTCA
GCAGCCATGGCTCAGTTGTTTTAC -> CAGCCATGGCTCAGTTGTTTTACT
GAACGTTGTCGTGTAAGGTAGCCA -> AACGTTGTCGTGTAAGGTAGCCAC
GCAGCGGCATGACTATAGGATCGT -> CAGCGGCATGACTATAGGATCGTC
CGATCCGGGATGAATGATTATGGG -> GATCCGGGATGAATGATTATGGGT
GGAGACCTGAATTAGAGATACTCT -> GAGACCTGAATTAGAGATACTCTG
TACAGGGTTCCCGCGACGGCGCAA -> ACAGGGTTCCCGCGACGGCGCAAG
CGGATATTCGGAGAAGTAGTCCTC -> GGATATTCGGAGAAGTAGTCCTCT
ACTGTCGTCTTCTGACAGGTTAGG -> CTGTCGTCTTCTGACAGGTTAGGT
ACACATTTGGATCGACCGATTAAC -> CACATTTGGATCGACCGATTAACC
ATTAGTCGTCCGTCCAGCAGACCG -> TTAGTCGTCCGTCCAGCAGACCGA
ACTGTTTAATCAGCGATACGGACA -> CTGTTTAATCAGCGATACGGACAG
AAACTCGGGGCCTCATGGCCGGTA -> AACTCGGGGCCTCATGGCCGGTAG
ATTGGTGCAGCCATGGCTCAGTTG -> TTGGTGCAGCCATGGCTCAGTTGT
TAACCTCCATCTACCGTGTGTCGA -> AACCTCCATCTACCGTGTGTCGAG
GTCGTGTAAGGTAGCCACAGACGC -> TCGTGTAAGGTAGCCACAGACGCC
CTACAAATGGTTTTGATTCACTGT -> TACAAATGGTTTTGATTCACTGTG
AACCTCCATCTACCGTGTGTCGAG -> ACCTCCATCTACCGTGTGTCGAGC
GATAAACGGCTGTCAGCCGCTACT -> ATAAACGGCTGTCAGCCGCTACTT
TTGATTTATGACCGACTCGTGTTA -> TGATTTATGACCGACTCGTGTTAA
ACCATGTGAACATGAACGGTGGAG -> CCATGTGAACATGAACGGTGGAGT
GACGCCTATATTTGAACTGGCACA -> ACGCCTATATTTGAACTGGCACAT
CCACAACCCCTGCCGGTGATTGCT -> CACAACCCCTGCCGGTGATTGCTA
AGGGATTGGGTGGGTGCTCAATCG -> GGGATTGGGTGGGTGCTCAATCGC
TCGGGGCCTCATGGCCGGTAGCGG -> CGGGGCCTCATGGCCGGTAGCGGG
TGTGGGAAGTGCCACTCAAGAGGG -> GTGGGAAGTGCCACTCAAGAGGGG
CAGCGCACCTTCTGCTGCCACCAA -> AGCGCACCTTCTGCTGCCACCAAT
TGGTTTTGATTCACTGTGGGAAGT -> GGTTTTGATTCACTGTGGGAAGTG
GCGCAAGCGTCGTGGAGAAACATG -> CGCAAGCGTCGTGGAGAAACATGA
ACAGAAATTCAACCGCCGAGTGTG -> CAGAAATTCAACCGCCGAGTGTGT
CTGAAGACTCATGACGGAGGTATT -> TGAAGACTCATGACGGAGGTATTT
AAACTGGTCCGTGGGATAGCTGTC -> AACTGGTCCGTGGGATAGCTGTCA
AAATACTTCAAGTTCCACAATTAG -> AATACTTCAAGTTCCACAATTAGT
TAACATAGTCTGTCCGGGATTCGG -> AACATAGTCTGTCCGGGATTCGGT
CACATTTGGATCGACCGATTAACC -> ACATTTGGATCGACCGATTAACCG
TGGAACCGCGCCGCCCTTCTAGGA -> GGAACCGCGCCGCCCTTCTAGGAG
CCACAGACGCCTATATTTGAACTG -> CACAGACGCCTATATTTGAACTGG
CGGTGGAGTCATTTGTCTGGAACC -> GGTGGAGTCATTTGTCTGGAACCG
TCCACCTACCAGGGTCACTCACTG -> CCACCTACCAGGGTCACTCACTGA
GGAGTCATTTGTCTGGAACCGCGC -> GAGTCATTTGTCTGGAACCGCGCC
AAACAGACGGCCTGTTGGGATGTA -> AACAGACGGCCTGTTGGGATGTAA
CAGACTGCGACCGGTTAGGTAATC -> AGACTGCGACCGGTTAGGTAATCG
ATATAACTTCCTTCATCTTGGTGA -> TATAACTTCCTTCATCTTGGTGAT
ACCTTTTTTGAAACAAAATCTAAG -> CCTTTTTTGAAACAAAATCTAAGT
ACCAATTGTGACCATGTGAACATG -> CCAATTGTGACCATGTGAACATGA
TGTCACGGTTGTGATATACCTTTT -> GTCACGGTTGTGATATACCTTTTT
GTGGAGAAACATGAACGATTTTTT -> TGGAGAAACATGAACGATTTTTTC
AGATACTCTGGTAACCTCCATCTA -> GATACTCTGGTAACCTCCATCTAC
TGTGCAGAAAATACTTCAAGTTCC -> GTGCAGAAAATACTTCAAGTTCCA
CACAAGATTGGTGCAGCCATGGCT -> ACAAGATTGGTGCAGCCATGGCTC
CTGGTGCCGGGGATGAACGTTGTC -> TGGTGCCGGGGATGAACGTTGTCG
GGATTTTTTATCGACCAATTGTGA -> GATTTTTTATCGACCAATTGTGAC
TCGCCTACATTACGTAGGACTACC -> CGCCTACATTACGTAGGACTACCG
ATTTGAACTGGCACATCGCGAAGG -> TTTGAACTGGCACATCGCGAAGGA
AGACAATTTATACGACCTCCTAGA -> GACAATTTATACGACCTCCTAGAT
ATTAGAGATACTCTGGTAACCTCC -> TTAGAGATACTCTGGTAACCTCCA
ACAACAACGAGACCAGGCGATTAA -> CAACAACGAGACCAGGCGATTAAC
TGCGGGCATACTGACACGAAGTCA -> GCGGGCATACTGACACGAAGTCAA
ATCATTCTATGCGTAGCTACGGGC -> TCATTCTATGCGTAGCTACGGGCG
TTAGGTCATGGCTGGTGCCGGGGA -> TAGGTCATGGCTGGTGCCGGGGAT
CTAGGAGACAGGGATTGGGTGGGT -> TAGGAGACAGGGATTGGGTGGGTG
GCTGGGGTTGACCACAACCCCTGC -> CTGGGGTTGACCACAACCCCTGCC
CATACTGACACGAAGTCAAAGCTC -> ATACTGACACGAAGTCAAAGCTCT
ATCGACCAATTGTGACCATGTGAA -> TCGACCAATTGTGACCATGTGAAC
TCGATCGTCATAAGCTCTAGTTAG -> CGATCGTCATAAGCTCTAGTTAGG
AGTAGTCCTCTCACAGGTCCACAC -> GTAGTCCTCTCACAGGTCCACACA
TAATCTTGGTACAACGATCCGGGA -> AATCTTGGTACAACGATCCGGGAT
TGTCTCGCATAACTCACTCGTTAC -> GTCTCGCATAACTCACTCGTTACG
TCGCGATCGCGCGTTGTCTCGCAT -> CGCGATCGCGCGTTGTCTCGCATA
TTATCGACCAATTGTGACCATGTG -> TATCGACCAATTGTGACCATGTGA
AACATGAACGGTGGAGTCATTTGT -> ACATGAACGGTGGAGTCATTTGTC
ACGACCTCCTAGATCTGAACAACA -> CGACCTCCTAGATCTGAACAACAA
ATGATTCATGATATAATTCTGCCG -> TGATTCATGATATAATTCTGCCGC
GATGAAAACAGACGGCCTGTTGGG -> ATGAAAACAGACGGCCTGTTGGGA
CCGAGTGTGTAGTGGTAGAGGAGT -> CGAGTGTGTAGTGGTAGAGGAGTT
CTCACAGGTCCACACATTTGGATC -> TCACAGGTCCACACATTTGGATCG
AAAACAGACGGCCTGTTGGGATGT -> AAACAGACGGCCTGTTGGGATGTA
GATTTATCATTCTATGCGTAGCTA -> ATTTATCATTCTATGCGTAGCTAC
GATGTAAGGAGGTTACAACACAGA -> ATGTAAGGAGGTTACAACACAGAA
AACATAGTCTGTCCGGGATTCGGT -> ACATAGTCTGTCCGGGATTCGGTC
CGTTGTCGTGTAAGGTAGCCACAG -> GTTGTCGTGTAAGGTAGCCACAGA
TCCAGTGCTCCTAGTACTTGAACA -> CCAGTGCTCCTAGTACTTGAACAG
GATCGTCATAAGCTCTAGTTAGGG -> ATCGTCATAAGCTCTAGTTAGGGC
GACCAATTGTGACCATGTGAACAT -> ACCAATTGTGACCATGTGAACATG
CATTCTATGCGTAGCTACGGGCGA -> ATTCTATGCGTAGCTACGGGCGAT
TACCGTGTGTCGAGCGTGGTGCTT -> ACCGTGTGTCGAGCGTGGTGCTTC
CAAAGCTCTTGATTTATGACCGAC -> AAAGCTCTTGATTTATGACCGACT
CGACACACACTGATGCGTGGAGGC -> GACACACACTGATGCGTGGAGGCC
GTTGACCACAACCCCTGCCGGTGA -> TTGACCACAACCCCTGCCGGTGAT
GCGGGCCTTTATCCCACCACAGGC -> CGGGCCTTTATCCCACCACAGGCG
TCTCACAAATCCCCTCTATTTACC -> CTCACAAATCCCCTCTATTTACCA
AGGGATCCGGCTGGGGTTGACCAC -> GGGATCCGGCTGGGGTTGACCACA
CAGGCAAAGATCGAACCCACGCGA -> AGGCAAAGATCGAACCCACGCGAT
GACTATAGGATCGTCGGTAGCTGG -> ACTATAGGATCGTCGGTAGCTGGT
ATTATATGGAACACGCATTGCGTG -> TTATATGGAACACGCATTGCGTGC
ATTCCCATGTTCGTGGATATAACC -> TTCCCATGTTCGTGGATATAACCT
TCTGGAACCGCGCCGCCCTTCTAG -> CTGGAACCGCGCCGCCCTTCTAGG
CTCGTTACGATGAAAACAGACGGC -> TCGTTACGATGAAAACAGACGGCC
AAATCGATCGTCATAAGCTCTAGT -> AATCGATCGTCATAAGCTCTAGTT
CCTATATTTGAACTGGCACATCGC -> CTATATTTGAACTGGCACATCGCG
GAGAAGTAGTCCTCTCACAGGTCC -> AGAAGTAGTCCTCTCACAGGTCCA
ATGCAGACACGTTCCCTCGAAACC -> TGCAGACACGTTCCCTCGAAACCC
ACAGACGGCCTGTTGGGATGTAAG -> CAGACGGCCTGTTGGGATGTAAGG
CCCTGCCGGTGATTGCTAAGACCC -> CCTGCCGGTGATTGCTAAGACCCT
CAATTTATACGACCTCCTAGATCT -> AATTTATACGACCTCCTAGATCTG
CGAGCGTGGTGCTTCTTACGCTCG -> GAGCGTGGTGCTTCTTACGCTCGG
AAGTTCCACAATTAGTCGTCCGTC -> AGTTCCACAATTAGTCGTCCGTCC
ACTGATGCGTGGAGGCCCACTGTC -> CTGATGCGTGGAGGCCCACTGTCA
AGCGTCGTGGAGAAACATGAACGA -> GCGTCGTGGAGAAACATGAACGAT
GCTGGTGCCGGGGATGAACGTTGT -> CTGGTGCCGGGGATGAACGTTGTC
GTGCACATTACGTAAACTCGAGTA -> TGCACATTACGTAAACTCGAGTAA
TACCTACGAAGCACAAGATTGGTG -> ACCTACGAAGCACAAGATTGGTGC
ACCAGCCCCCTCACGCGGAATTCC -> CCAGCCCCCTCACGCGGAATTCCT
ACCGCAACCGACACACACTGATGC -> CCGCAACCGACACACACTGATGCG
TAAGACCCTGAAGAAGACAATTCT -> AAGACCCTGAAGAAGACAATTCTC
AGGGTTCCCGCGACGGCGCAAGCG -> GGGTTCCCGCGACGGCGCAAGCGT
CAGTTGTTTTACTTCATCTCAGCG -> AGTTGTTTTACTTCATCTCAGCGA
TAGCGCCTCGATTGCAACATCGGA -> AGCGCCTCGATTGCAACATCGGAT
TTCTCGCAGTGCTCCAGGAATGTG -> TCTCGCAGTGCTCCAGGAATGTGC
TTGAACAGGCAAAGATCGAACCCA -> TGAACAGGCAAAGATCGAACCCAC
TCACTCACTGAAGACTCATGACGG -> CACTCACTGAAGACTCATGACGGA
GCCTCGATTGCAACATCGGATGTA -> CCTCGATTGCAACATCGGATGTAT
TGACCATTATCTCGGATATTCGGA -> GACCATTATCTCGGATATTCGGAG
ACGAAGTCAAAGCTCTTGATTTAT -> CGAAGTCAAAGCTCTTGATTTATG
CGGCATGACTATAGGATCGTCGGT -> GGCATGACTATAGGATCGTCGGTA
TAGCTGTCACGGTTGTGATATACC -> AGCTGTCACGGTTGTGATATACCT
ACCGACTCGTGTTAAGAAAAACCT -> CCGACTCGTGTTAAGAAAAACCTG
GACCAGGCGATTAACAAACTCGGT -> ACCAGGCGATTAACAAACTCGGTT
GGTTAACTGTTTAATCAGCGATAC -> GTTAACTGTTTAATCAGCGATACG
CGCCGAGTGTGTAGTGGTAGAGGA -> GCCGAGTGTGTAGTGGTAGAGGAG
TATTTACCAGCCCCCTCACGCGGA -> ATTTACCAGCCCCCTCACGCGGAA
GTCACTAGATAGACAATTTATACG -> TCACTAGATAGACAATTTATACGA
ATGGAACACGCATTGCGTGCAAAT -> TGGAACACGCATTGCGTGCAAATG
GCCGCTACTTAGCTTTTTACTGCC -> CCGCTACTTAGCTTTTTACTGCCG
CAGGCGATTAACAAACTCGGTTAA -> AGGCGATTAACAAACTCGGTTAAC
TTAGAGATACTCTGGTAACCTCCA -> TAGAGATACTCTGGTAACCTCCAT
GCGTAGCTACGGGCGATGCTCCGG -> CGTAGCTACGGGCGATGCTCCGGC
TCATGGCTGGTGCCGGGGATGAAC -> CATGGCTGGTGCCGGGGATGAACG
AAGCACAAGATTGGTGCAGCCATG -> AGCACAAGATTGGTGCAGCCATGG
GCCGCCCTTCTAGGAGACAGGGAT -> CCGCCCTTCTAGGAGACAGGGATT
TACGCTCGGAAGAAACTGGTCCGT -> ACGCTCGGAAGAAACTGGTCCGTG
GCGGTACTCTATATAACTTCCTTC -> CGGTACTCTATATAACTTCCTTCA
ACCAATTATATGGAACACGCATTG -> CCAATTATATGGAACACGCATTGC
ACGCCTATATTTGAACTGGCACAT -> CGCCTATATTTGAACTGGCACATC
CAGTGCTCCAGGAATGTGCAGAAA -> AGTGCTCCAGGAATGTGCAGAAAA
ACGGCCTGTTGGGATGTAAGGAGG -> CGGCCTGTTGGGATGTAAGGAGGT
AACCGCCGAGTGTGTAGTGGTAGA -> ACCGCCGAGTGTGTAGTGGTAGAG
CAATTATATGGAACACGCATTGCG -> AATTATATGGAACACGCATTGCGT
AACAAACTCGGTTAACTGTTTAAT -> ACAAACTCGGTTAACTGTTTAATC
GGGTTCCCGCGACGGCGCAAGCGT -> GGTTCCCGCGACGGCGCAAGCGTC
CCATGGGCGTCGGATAAACGGCTG -> CATGGGCGTCGGATAAACGGCTGT
CCCTTCTAGGAGACAGGGATTGGG -> CCTTCTAGGAGACAGGGATTGGGT
AGGTCCACACATTTGGATCGACCG -> GGTCCACACATTTGGATCGACCGA
GCCCGGGTAGGGCTACAAATGGTT -> CCCGGGTAGGGCTACAAATGGTTT
GTCGTCTTCTGACAGGTTAGGTCA -> TCGTCTTCTGACAGGTTAGGTCAT
CTTTCCCTCCCGTAAATCAGACTG -> TTTCCCTCCCGTAAATCAGACTGC
GAACACGCATTGCGTGCAAATGCT -> AACACGCATTGCGTGCAAATGCTA
GTACTTACAGGGTTCCCGCGACGG -> TACTTACAGGGTTCCCGCGACGGC
CTCAATCGCCTACATTACGTAGGA -> TCAATCGCCTACATTACGTAGGAC
ACGCCAAATCGATCGTCATAAGCT -> CGCCAAATCGATCGTCATAAGCTC
GTGCTTCTTACGCTCGGAAGAAAC -> TGCTTCTTACGCTCGGAAGAAACT
CGTAGGTAGTTCTTTAGCGCCTCG -> GTAGGTAGTTCTTTAGCGCCTCGA
GTAAGGAGGTTACAACACAGAAAT -> TAAGGAGGTTACAACACAGAAATT
ATAGGATCGTCGGTAGCTGGTATG -> TAGGATCGTCGGTAGCTGGTATGA
TAGTTAGGGCGGATTTGGAACTCA -> AGTTAGGGCGGATTTGGAACTCAC
ATTACGTAAACTCGAGTAATCTTG -> TTACGTAAACTCGAGTAATCTTGG
TGGGATGTAAGGAGGTTACAACAC -> GGGATGTAAGGAGGTTACAACACA
ACGTTGTCGTGTAAGGTAGCCACA -> CGTTGTCGTGTAAGGTAGCCACAG
TTTGGATCGACCGATTAACCGCAG -> TTGGATCGACCGATTAACCGCAGA
CGTAAACTCGAGTAATCTTGGTAC -> GTAAACTCGAGTAATCTTGGTACA
GGTGATTGCTAAGACCCTGAAGAA -> GTGATTGCTAAGACCCTGAAGAAG
ATTCGCGATCGCGCGTTGTCTCGC -> TTCGCGATCGCGCGTTGTCTCGCA
ATGATTATGGGTCGTATGGAAGGA -> TGATTATGGGTCGTATGGAAGGAT
GAAGAAACTGGTCCGTGGGATAGC -> AAGAAACTGGTCCGTGGGATAGCT
CAGGCGCTCGATACGCCCGGGTAG -> AGGCGCTCGATACGCCCGGGTAGG
AGCTGGTATGATTCATGATATAAT -> GCTGGTATGATTCATGATATAATT
CTGCCGGTGATTGCTAAGACCCTG -> TGCCGGTGATTGCTAAGACCCTGA
ATTGGAGACCTGAATTAGAGATAC -> TTGGAGACCTGAATTAGAGATACT
TATTTTTTTGCTTTCCCTCCCGTA -> ATTTTTTTGCTTTCCCTCCCGTAA
TAGTCTGTCCGGGATTCGGTCCAC -> AGTCTGTCCGGGATTCGGTCCACC
TTATGACCGACTCGTGTTAAGAAA -> TATGACCGACTCGTGTTAAGAAAA
CTCTTGGATGAATCCCACCAGCGC -> TCTTGGATGAATCCCACCAGCGCA
AATCAGCGATACGGACAGGGCGGT -> ATCAGCGATACGGACAGGGCGGTA
CCAGCGCACCTTCTGCTGCCACCA -> CAGCGCACCTTCTGCTGCCACCAA
GCATTGCGTGCAAATGCTAGTACT -> CATTGCGTGCAAATGCTAGTACTT
AGTTAGGGCGGATTTGGAACTCAC -> GTTAGGGCGGATTTGGAACTCACT
CCTACCAGGGTCACTCACTGAAGA -> CTACCAGGGTCACTCACTGAAGAC
AGTGCACATTACGTAAACTCGAGT -> GTGCACATTACGTAAACTCGAGTA
AATACTTCAAGTTCCACAATTAGT -> ATACTTCAAGTTCCACAATTAGTC
TACGTAGGACTACCGCAACCGACA -> ACGTAGGACTACCGCAACCGACAC
GTTTTGATTCACTGTGGGAAGTGC -> TTTTGATTCACTGTGGGAAGTGCC
TTCGCGATCGCGCGTTGTCTCGCA -> TCGCGATCGCGCGTTGTCTCGCAT
CCTGAAGAAGACAATTCTCGCAGT -> CTGAAGAAGACAATTCTCGCAGTG
GCGAGTGATTCGCGATCGCGCGTT -> CGAGTGATTCGCGATCGCGCGTTG
CCGGGGTGTGTCCAGTGCTCCTAG -> CGGGGTGTGTCCAGTGCTCCTAGT
TCAGTTGTTTTACTTCATCTCAGC -> CAGTTGTTTTACTTCATCTCAGCG
GGTCATGGCTGGTGCCGGGGATGA -> GTCATGGCTGGTGCCGGGGATGAA
CACGCGGAATTCCTGCAATATTGG -> ACGCGGAATTCCTGCAATATTGGA
GTCATTTGTCTGGAACCGCGCCGC -> TCATTTGTCTGGAACCGCGCCGCC
TGCCGGGGATGAACGTTGTCGTGT -> GCCGGGGATGAACGTTGTCGTGTA
CTAGTACTTACAGGGTTCCCGCGA -> TAGTACTTACAGGGTTCCCGCGAC
CCGCAGATCGTCGGGAATTAACAT -> CGCAGATCGTCGGGAATTAACATA
CGAAGCAGCGGCATGACTATAGGA -> GAAGCAGCGGCATGACTATAGGAT
TGGTATGATTCATGATATAATTCT -> GGTATGATTCATGATATAATTCTG
GTGATTCGCGATCGCGCGTTGTCT -> TGATTCGCGATCGCGCGTTGTCTC
TCTTGGTACAACGATCCGGGATGA -> CTTGGTACAACGATCCGGGATGAA
CAAATGGTTTTGATTCACTGTGGG -> AAATGGTTTTGATTCACTGTGGGA
CATGGCTGGTGCCGGGGATGAACG -> ATGGCTGGTGCCGGGGATGAACGT
ACCACAGGCGCTCGATACGCCCGG -> CCACAGGCGCTCGATACGCCCGGG
GACCGAACAGCAGATCTTCTCACA -> ACCGAACAGCAGATCTTCTCACAA
TTATACGACCTCCTAGATCTGAAC -> TATACGACCTCCTAGATCTGAACA
TCAGCGATACGGACAGGGCGGTAC -> CAGCGATACGGACAGGGCGGTACT
ACGGCTGTCAGCCGCTACTTAGCT -> CGGCTGTCAGCCGCTACTTAGCTT
TCGAGCGTGGTGCTTCTTACGCTC -> CGAGCGTGGTGCTTCTTACGCTCG
TTGGTGCAGCCATGGCTCAGTTGT -> TGGTGCAGCCATGGCTCAGTTGTT
ATACGCCAAATCGATCGTCATAAG -> TACGCCAAATCGATCGTCATAAGC
GGAACTCACTCTTGGATGAATCCC -> GAACTCACTCTTGGATGAATCCCA
CTCCTAGTACTTGAACAGGCAAAG -> TCCTAGTACTTGAACAGGCAAAGA
GGGCTACAAATGGTTTTGATTCAC -> GGCTACAAATGGTTTTGATTCACT
GGTCACTCACTGAAGACTCATGAC -> GTCACTCACTGAAGACTCATGACG
TTCCCTCCCGTAAATCAGACTGCG -> TCCCTCCCGTAAATCAGACTGCGA
CCTGAATTAGAGATACTCTGGTAA -> CTGAATTAGAGATACTCTGGTAAC
ACAGGGATTGGGTGGGTGCTCAAT -> CAGGGATTGGGTGGGTGCTCAATC
CCAGGGTCACTCACTGAAGACTCA -> CAGGGTCACTCACTGAAGACTCAT
GTGTCGAGCGTGGTGCTTCTTACG -> TGTCGAGCGTGGTGCTTCTTACGC
TGTTGGGATGTAAGGAGGTTACAA -> GTTGGGATGTAAGGAGGTTACAAC
CCACTGTCATGCGGGCATACTGAC -> CACTGTCATGCGGGCATACTGACA
TACATTGCCGGGGTGTGTCCAGTG -> ACATTGCCGGGGTGTGTCCAGTGC
CGCATAACTCACTCGTTACGATGA -> GCATAACTCACTCGTTACGATGAA
TTCCCATGTTCGTGGATATAACCT -> TCCCATGTTCGTGGATATAACCTA
CCAGGCGATTAACAAACTCGGTTA -> CAGGCGATTAACAAACTCGGTTAA
TGCACATTACGTAAACTCGAGTAA -> GCACATTACGTAAACTCGAGTAAT
CAAACTCGGTTAACTGTTTAATCA -> AAACTCGGTTAACTGTTTAATCAG
GTTGGGATGTAAGGAGGTTACAAC -> TTGGGATGTAAGGAGGTTACAACA
ACCTTCTGCTGCCACCAATTATAT -> CCTTCTGCTGCCACCAATTATATG
GTTCCACAATTAGTCGTCCGTCCA -> TTCCACAATTAGTCGTCCGTCCAG
CGACTCGTGTTAAGAAAAACCTGG -> GACTCGTGTTAAGAAAAACCTGGC
TAACTCACTCGTTACGATGAAAAC -> AACTCACTCGTTACGATGAAAACA
TTATCCCACCACAGGCGCTCGATA -> TATCCCACCACAGGCGCTCGATAC
GTTCCCGCGACGGCGCAAGCGTCG -> TTCCCGCGACGGCGCAAGCGTCGT
GGCCTCATGGCCGGTAGCGGGCCT -> GCCTCATGGCCGGTAGCGGGCCTT
CAGACCGAACAGCAGATCTTCTCA -> AGACCGAACAGCAGATCTTCTCAC
AACTCGGTTAACTGTTTAATCAGC -> ACTCGGTTAACTGTTTAATCAGCG
GAAGGATTTTTTATCGACCAATTG -> AAGGATTTTTTATCGACCAATTGT
GAAGAAGACAATTCTCGCAGTGCT -> AAGAAGACAATTCTCGCAGTGCTC
GGGCGTCGGATAAACGGCTGTCAG -> GGCGTCGGATAAACGGCTGTCAGC
GAGACCTGAATTAGAGATACTCTG -> AGACCTGAATTAGAGATACTCTGG
TGGCGAAGCAGCGGCATGACTATA -> GGCGAAGCAGCGGCATGACTATAG
TACGACAGATAGACAGTCACTAGA -> ACGACAGATAGACAGTCACTAGAT
TGCGTGCAAATGCTAGTACTTACA -> GCGTGCAAATGCTAGTACTTACAG
TCGAGTAATCTTGGTACAACGATC -> CGAGTAATCTTGGTACAACGATCC
ATCTACCGTGTGTCGAGCGTGGTG -> TCTACCGTGTGTCGAGCGTGGTGC
ACGACAGATAGACAGTCACTAGAT -> CGACAGATAGACAGTCACTAGATA
CAAATCCCCTCTATTTACCAGCCC -> AAATCCCCTCTATTTACCAGCCCC
ACATGAACGGTGGAGTCATTTGTC -> CATGAACGGTGGAGTCATTTGTCT
CCTGCCGGTGATTGCTAAGACCCT -> CTGCCGGTGATTGCTAAGACCCTG
CACGGTTGTGATATACCTTTTTTG -> ACGGTTGTGATATACCTTTTTTGA
CGATACGCCCGGGTAGGGCTACAA -> GATACGCCCGGGTAGGGCTACAAA
GACACGTTCCCTCGAAACCCACTC -> ACACGTTCCCTCGAAACCCACTCA
AAGGTAGCCACAGACGCCTATATT -> AGGTAGCCACAGACGCCTATATTT
TCACTAGATAGACAATTTATACGA -> CACTAGATAGACAATTTATACGAC
ACCAGGCGATTAACAAACTCGGTT -> CCAGGCGATTAACAAACTCGGTTA
CGCTCGATACGCCCGGGTAGGGCT -> GCTCGATACGCCCGGGTAGGGCTA
CTGTCAGCCGCTACTTAGCTTTTT -> TGTCAGCCGCTACTTAGCTTTTTA
GACCTCCTAGATCTGAACAACAAC -> ACCTCCTAGATCTGAACAACAACG
AGCCGCTACTTAGCTTTTTACTGC -> GCCGCTACTTAGCTTTTTACTGCC
CGGGAATTAACATAGTCTGTCCGG -> GGGAATTAACATAGTCTGTCCGGG
TCGTCTTCTGACAGGTTAGGTCAT -> CGTCTTCTGACAGGTTAGGTCATG
CACCTTCTGCTGCCACCAATTATA -> ACCTTCTGCTGCCACCAATTATAT
CTGTCCGGGATTCGGTCCACCTAC -> TGTCCGGGATTCGGTCCACCTACC
ATGCGTAGCTACGGGCGATGCTCC -> TGCGTAGCTACGGGCGATGCTCCG
CTATAGGATCGTCGGTAGCTGGTA -> TATAGGATCGTCGGTAGCTGGTAT
AGATAGACAATTTATACGACCTCC -> GATAGACAATTTATACGACCTCCT
CTTGATTTATGACCGACTCGTGTT -> TTGATTTATGACCGACTCGTGTTA
CCGTAAATCAGACTGCGACCGGTT -> CGTAAATCAGACTGCGACCGGTTA
ATGCTCCGGCCTACATTGCCGGGG -> TGCTCCGGCCTACATTGCCGGGGT
GACAATTTATACGACCTCCTAGAT -> ACAATTTATACGACCTCCTAGATC
ATCCCACCACAGGCGCTCGATACG -> TCCCACCACAGGCGCTCGATACGC
CACTCGTTACGATGAAAACAGACG -> ACTCGTTACGATGAAAACAGACGG
CTTAGCTTTTTACTGCCGGAGGGA -> TTAGCTTTTTACTGCCGGAGGGAT
CTTTAGCGCCTCGATTGCAACATC -> TTTAGCGCCTCGATTGCAACATCG
GGGATGTAAGGAGGTTACAACACA -> GGATGTAAGGAGGTTACAACACAG
TCGGAAGAAACTGGTCCGTGGGAT -> CGGAAGAAACTGGTCCGTGGGATA
TCCGGCTGGGGTTGACCACAACCC -> CCGGCTGGGGTTGACCACAACCCC
GATGAACGTTGTCGTGTAAGGTAG -> ATGAACGTTGTCGTGTAAGGTAGC
ACGATTTTTTCTACAAACTGTCGT -> CGATTTTTTCTACAAACTGTCGTC
AGACGGCCTGTTGGGATGTAAGGA -> GACGGCCTGTTGGGATGTAAGGAG
CTCAGCGAGTGATTCGCGATCGCG -> TCAGCGAGTGATTCGCGATCGCGC
TGCGTAGCTACGGGCGATGCTCCG -> GCGTAGCTACGGGCGATGCTCCGG
CATCTACCGTGTGTCGAGCGTGGT -> ATCTACCGTGTGTCGAGCGTGGTG
TATTGGAGACCTGAATTAGAGATA -> ATTGGAGACCTGAATTAGAGATAC
CGTAGCTACGGGCGATGCTCCGGC -> GTAGCTACGGGCGATGCTCCGGCC
CTGGCGAAGCAGCGGCATGACTAT -> TGGCGAAGCAGCGGCATGACTATA
GTAGGACTACCGCAACCGACACAC -> TAGGACTACCGCAACCGACACACA
ATCTTGGTACAACGATCCGGGATG -> TCTTGGTACAACGATCCGGGATGA
ATTGGGTGGGTGCTCAATCGCCTA -> TTGGGTGGGTGCTCAATCGCCTAC
ACTCTATATAACTTCCTTCATCTT -> CTCTATATAACTTCCTTCATCTTG
TAACTACTGTGACCATTATCTCGG -> AACTACTGTGACCATTATCTCGGA
AATCTAAGTCATACGCCAAATCGA -> ATCTAAGTCATACGCCAAATCGAT
ACTGAAGACTCATGACGGAGGTAT -> CTGAAGACTCATGACGGAGGTATT
GTATTTTTTTGCTTTCCCTCCCGT -> TATTTTTTTGCTTTCCCTCCCGTA
CGATGCTCCGGCCTACATTGCCGG -> GATGCTCCGGCCTACATTGCCGGG
CCTAGCCCGTGGACCCATGGGCGT -> CTAGCCCGTGGACCCATGGGCGTC
GTGCCACTCAAGAGGGGTCTGAAC -> TGCCACTCAAGAGGGGTCTGAACG
TCCGGCCTACATTGCCGGGGTGTG -> CCGGCCTACATTGCCGGGGTGTGT
GGTGATCCCGTAGTGCACATTACG -> GTGATCCCGTAGTGCACATTACGT
TTGTCTCGCATAACTCACTCGTTA -> TGTCTCGCATAACTCACTCGTTAC
GGTAGAGGAGTTAGACATGCCTCA -> GTAGAGGAGTTAGACATGCCTCAG
CTACCAGGGTCACTCACTGAAGAC -> TACCAGGGTCACTCACTGAAGACT
GCCCTTCTAGGAGACAGGGATTGG -> CCCTTCTAGGAGACAGGGATTGGG
CGCAGTGCTCCAGGAATGTGCAGA -> GCAGTGCTCCAGGAATGTGCAGAA
CCCACTCAATGAGTCTACCTACGA -> CCACTCAATGAGTCTACCTACGAA
AAGAAACTGGTCCGTGGGATAGCT -> AGAAACTGGTCCGTGGGATAGCTG
TCTGACAGGTTAGGTCATGGCTGG -> CTGACAGGTTAGGTCATGGCTGGT
CTCGGAAGAAACTGGTCCGTGGGA -> TCGGAAGAAACTGGTCCGTGGGAT
GGTCTAACTACTGTGACCATTATC -> GTCTAACTACTGTGACCATTATCT
GGCCTACATTGCCGGGGTGTGTCC -> GCCTACATTGCCGGGGTGTGTCCA
GAGAAACATGAACGATTTTTTCTA -> AGAAACATGAACGATTTTTTCTAC
ACTGTGACCATTATCTCGGATATT -> CTGTGACCATTATCTCGGATATTC
CCTTCTGCTGCCACCAATTATATG -> CTTCTGCTGCCACCAATTATATGG
TGACTATAGGATCGTCGGTAGCTG -> GACTATAGGATCGTCGGTAGCTGG
GGTAGCGGGCCTTTATCCCACCAC -> GTAGCGGGCCTTTATCCCACCACA
TAGTGGTAGAGGAGTTAGACATGC -> AGTGGTAGAGGAGTTAGACATGCC
ACAGGCAAAGATCGAACCCACGCG -> CAGGCAAAGATCGAACCCACGCGA
CACTAGATAGACAATTTATACGAC -> ACTAGATAGACAATTTATACGACC
TCCACACATTTGGATCGACCGATT -> CCACACATTTGGATCGACCGATTA
CCCGCGACGGCGCAAGCGTCGTGG -> CCGCGACGGCGCAAGCGTCGTGGA
ACACACACTGATGCGTGGAGGCCC -> CACACACTGATGCGTGGAGGCCCA
CTTCATCTTGGTGATCCCGTAGTG -> TTCATCTTGGTGATCCCGTAGTGC
GCCTCAGAAAACTCGGGGCCTCAT -> CCTCAGAAAACTCGGGGCCTCATG
ATCGCCTACATTACGTAGGACTAC -> TCGCCTACATTACGTAGGACTACC
GTCTCGCATAACTCACTCGTTACG -> TCTCGCATAACTCACTCGTTACGA
TCGTCCGTCCAGCAGACCGAACAG -> CGTCCGTCCAGCAGACCGAACAGC
GAATGATTATGGGTCGTATGGAAG -> AATGATTATGGGTCGTATGGAAGG
CATTTGTCTGGAACCGCGCCGCCC -> ATTTGTCTGGAACCGCGCCGCCCT
TCGATTGCAACATCGGATGTATTG -> CGATTGCAACATCGGATGTATTGA
TAAATCAGACTGCGACCGGTTAGG -> AAATCAGACTGCGACCGGTTAGGT
CGGCTGTCAGCCGCTACTTAGCTT -> GGCTGTCAGCCGCTACTTAGCTTT
TCTTCTGACAGGTTAGGTCATGGC -> CTTCTGACAGGTTAGGTCATGGCT
CAGCAGATCTTCTCACAAATCCCC -> AGCAGATCTTCTCACAAATCCCCT
GCCTGTTGGGATGTAAGGAGGTTA -> CCTGTTGGGATGTAAGGAGGTTAC
TAAGTCATACGCCAAATCGATCGT -> AAGTCATACGCCAAATCGATCGTC
CGTGTGTCGAGCGTGGTGCTTCTT -> GTGTGTCGAGCGTGGTGCTTCTTA
ACGCGGAATTCCTGCAATATTGGA -> CGCGGAATTCCTGCAATATTGGAG
TCTCACAGGTCCACACATTTGGAT -> CTCACAGGTCCACACATTTGGATC
TAAGGAGGTTACAACACAGAAATT -> AAGGAGGTTACAACACAGAAATTC
TGGCTGGTGCCGGGGATGAACGTT -> GGCTGGTGCCGGGGATGAACGTTG
ATTTGGAACTCACTCTTGGATGAA -> TTTGGAACTCACTCTTGGATGAAT
CAGATAGACAGTCACTAGATAGAC -> AGATAGACAGTCACTAGATAGACA
TTACGATGAAAACAGACGGCCTGT -> TACGATGAAAACAGACGGCCTGTT
CGGGTAGGGCTACAAATGGTTTTG -> GGGTAGGGCTACAAATGGTTTTGA
GAAACAAAATCTAAGTCATACGCC -> AAACAAAATCTAAGTCATACGCCA
GAACAGGCAAAGATCGAACCCACG -> AACAGGCAAAGATCGAACCCACGC
TGGGTCGTATGGAAGGATGCAGAC -> GGGTCGTATGGAAGGATGCAGACA
CGATACGGACAGGGCGGTACTCTA -> GATACGGACAGGGCGGTACTCTAT
AAATCTAAGTCATACGCCAAATCG -> AATCTAAGTCATACGCCAAATCGA
GAATTCCTGCAATATTGGAGACCT -> AATTCCTGCAATATTGGAGACCTG
ATTCACTGTGGGAAGTGCCACTCA -> TTCACTGTGGGAAGTGCCACTCAA
CTTTATCCCACCACAGGCGCTCGA -> TTTATCCCACCACAGGCGCTCGAT
CCTTTATCCCACCACAGGCGCTCG -> CTTTATCCCACCACAGGCGCTCGA
CAGGTTAGGTCATGGCTGGTGCCG -> AGGTTAGGTCATGGCTGGTGCCGG
ACCCACGCGATACGACAGATAGAC -> CCCACGCGATACGACAGATAGACA
CGCGCGTTGTCTCGCATAACTCAC -> GCGCGTTGTCTCGCATAACTCACT
CCACGCGATACGACAGATAGACAG -> CACGCGATACGACAGATAGACAGT
TGATATACCTTTTTTGAAACAAAA -> GATATACCTTTTTTGAAACAAAAT
GGCTGGGGTTGACCACAACCCCTG -> GCTGGGGTTGACCACAACCCCTGC
CTATATTTGAACTGGCACATCGCG -> TATATTTGAACTGGCACATCGCGA
CCCTCGAAACCCACTCAATGAGTC -> CCTCGAAACCCACTCAATGAGTCT
AGTGCTCCAGGAATGTGCAGAAAA -> GTGCTCCAGGAATGTGCAGAAAAT
CTGATGCGTGGAGGCCCACTGTCA -> TGATGCGTGGAGGCCCACTGTCAT
CCACTCAATGAGTCTACCTACGAA -> CACTCAATGAGTCTACCTACGAAG
GGGGTGTGTCCAGTGCTCCTAGTA -> GGGTGTGTCCAGTGCTCCTAGTAC
ACGGTGGAGTCATTTGTCTGGAAC -> CGGTGGAGTCATTTGTCTGGAACC
GTAGCCACAGACGCCTATATTTGA -> TAGCCACAGACGCCTATATTTGAA
ACGAGACCAGGCGATTAACAAACT -> CGAGACCAGGCGATTAACAAACTC
TTTTACTTCATCTCAGCGAGTGAT -> TTTACTTCATCTCAGCGAGTGATT
GACGGAGGTATTTTTTTGCTTTCC -> ACGGAGGTATTTTTTTGCTTTCCC
GGGTGTGTCCAGTGCTCCTAGTAC -> GGTGTGTCCAGTGCTCCTAGTACT
TGAACAGGCAAAGATCGAACCCAC -> GAACAGGCAAAGATCGAACCCACG
CGCTCGGAAGAAACTGGTCCGTGG -> GCTCGGAAGAAACTGGTCCGTGGG
CTGTGGGAAGTGCCACTCAAGAGG -> TGTGGGAAGTGCCACTCAAGAGGG
ACATTACGTAGGACTACCGCAACC -> CATTACGTAGGACTACCGCAACCG
AGTTGTTTTACTTCATCTCAGCGA -> GTTGTTTTACTTCATCTCAGCGAG
GATATACCTTTTTTGAAACAAAAT -> ATATACCTTTTTTGAAACAAAATC
TAGTTCTTTAGCGCCTCGATTGCA -> AGTTCTTTAGCGCCTCGATTGCAA
CTGAACAACAACGAGACCAGGCGA -> TGAACAACAACGAGACCAGGCGAT
CTCCTAGATCTGAACAACAACGAG -> TCCTAGATCTGAACAACAACGAGA
GTAGCTACGGGCGATGCTCCGGCC -> TAGCTACGGGCGATGCTCCGGCCT
TGATTGCTAAGACCCTGAAGAAGA -> GATTGCTAAGACCCTGAAGAAGAC
CTTTTTTGAAACAAAATCTAAGTC -> TTTTTTGAAACAAAATCTAAGTCA
ATTGCAACATCGGATGTATTGATT -> TTGCAACATCGGATGTATTGATTT
GAGGGATCCGGCTGGGGTTGACCA -> AGGGATCCGGCTGGGGTTGACCAC
CTTCTGCTGCCACCAATTATATGG -> TTCTGCTGCCACCAATTATATGGA
TGATGCGTGGAGGCCCACTGTCAT -> GATGCGTGGAGGCCCACTGTCATG
AGATCTGAACAACAACGAGACCAG -> GATCTGAACAACAACGAGACCAGG
AAATCAGACTGCGACCGGTTAGGT -> AATCAGACTGCGACCGGTTAGGTA
ATACGACCTCCTAGATCTGAACAA -> TACGACCTCCTAGATCTGAACAAC
CGACAGATAGACAGTCACTAGATA -> GACAGATAGACAGTCACTAGATAG
GTAACCTCCATCTACCGTGTGTCG -> TAACCTCCATCTACCGTGTGTCGA
TTCGGTCCACCTACCAGGGTCACT -> TCGGTCCACCTACCAGGGTCACTC
CATTACGTAGGACTACCGCAACCG -> ATTACGTAGGACTACCGCAACCGA
GGCGATGCTCCGGCCTACATTGCC -> GCGATGCTCCGGCCTACATTGCCG
ATCGATCGTCATAAGCTCTAGTTA -> TCGATCGTCATAAGCTCTAGTTAG
CGCGACGGCGCAAGCGTCGTGGAG -> GCGACGGCGCAAGCGTCGTGGAGA
TTGTCTGGAACCGCGCCGCCCTTC -> TGTCTGGAACCGCGCCGCCCTTCT
TGAGTCTACCTACGAAGCACAAGA -> GAGTCTACCTACGAAGCACAAGAT
GCGCGTTGTCTCGCATAACTCACT -> CGCGTTGTCTCGCATAACTCACTC
CCCATGTTCGTGGATATAACCTAG -> CCATGTTCGTGGATATAACCTAGC
GAACGGTGGAGTCATTTGTCTGGA -> AACGGTGGAGTCATTTGTCTGGAA
AAAAACCTGGCGAAGCAGCGGCAT -> AAAACCTGGCGAAGCAGCGGCATG
CCCTGAAGAAGACAATTCTCGCAG -> CCTGAAGAAGACAATTCTCGCAGT
CCGACTCGTGTTAAGAAAAACCTG -> CGACTCGTGTTAAGAAAAACCTGG
CACACACTGATGCGTGGAGGCCCA -> ACACACTGATGCGTGGAGGCCCAC
GATGCAGACACGTTCCCTCGAAAC -> ATGCAGACACGTTCCCTCGAAACC
GATGCGTGGAGGCCCACTGTCATG -> ATGCGTGGAGGCCCACTGTCATGC
GCCACTCAAGAGGGGTCTGAACGT -> CCACTCAAGAGGGGTCTGAACGTT
TCGATACGCCCGGGTAGGGCTACA -> CGATACGCCCGGGTAGGGCTACAA
CGGGGCCTCATGGCCGGTAGCGGG -> GGGGCCTCATGGCCGGTAGCGGGC
GTGCAGCCATGGCTCAGTTGTTTT -> TGCAGCCATGGCTCAGTTGTTTTA
CCCACTGTCATGCGGGCATACTGA -> CCACTGTCATGCGGGCATACTGAC
AAGACTCATGACGGAGGTATTTTT -> AGACTCATGACGGAGGTATTTTTT
GCGTCGTGGAGAAACATGAACGAT -> CGTCGTGGAGAAACATGAACGATT
ACTGCCGGAGGGATCCGGCTGGGG -> CTGCCGGAGGGATCCGGCTGGGGT
ATGGGCGTCGGATAAACGGCTGTC -> TGGGCGTCGGATAAACGGCTGTCA
TGCTAGTACTTACAGGGTTCCCGC -> GCTAGTACTTACAGGGTTCCCGCG
GGTTGACCACAACCCCTGCCGGTG -> GTTGACCACAACCCCTGCCGGTGA
CTAGATCTGAACAACAACGAGACC -> TAGATCTGAACAACAACGAGACCA
GAAACCCACTCAATGAGTCTACCT -> AAACCCACTCAATGAGTCTACCTA
TGAACATGAACGGTGGAGTCATTT -> GAACATGAACGGTGGAGTCATTTG
TCGTTACGATGAAAACAGACGGCC -> CGTTACGATGAAAACAGACGGCCT
TGGGCGTCGGATAAACGGCTGTCA -> GGGCGTCGGATAAACGGCTGTCAG
ATGCCTCAGAAAACTCGGGGCCTC -> TGCCTCAGAAAACTCGGGGCCTCA
CGTGGATATAACCTAGCCCGTGGA -> GTGGATATAACCTAGCCCGTGGAC
GGCGGTACTCTATATAACTTCCTT -> GCGGTACTCTATATAACTTCCTTC
CACTCTTGGATGAATCCCACCAGC -> ACTCTTGGATGAATCCCACCAGCG
AGTTCTTTAGCGCCTCGATTGCAA -> GTTCTTTAGCGCCTCGATTGCAAC
CATTGCCGGGGTGTGTCCAGTGCT -> ATTGCCGGGGTGTGTCCAGTGCTC
TGTGATATACCTTTTTTGAAACAA -> GTGATATACCTTTTTTGAAACAAA
TGCTAAGACCCTGAAGAAGACAAT -> GCTAAGACCCTGAAGAAGACAATT
AGACGCCTATATTTGAACTGGCAC -> GACGCCTATATTTGAACTGGCACA
CACAGGCGCTCGATACGCCCGGGT -> ACAGGCGCTCGATACGCCCGGGTA
CTAAGACCCTGAAGAAGACAATTC -> TAAGACCCTGAAGAAGACAATTCT
GCTGCCACCAATTATATGGAACAC -> CTGCCACCAATTATATGGAACACG
TCACAGGTCCACACATTTGGATCG -> CACAGGTCCACACATTTGGATCGA
TCTGCTGCCACCAATTATATGGAA -> CTGCTGCCACCAATTATATGGAAC
CATCTCAGCGAGTGATTCGCGATC -> ATCTCAGCGAGTGATTCGCGATCG
CCCCTCACGCGGAATTCCTGCAAT -> CCCTCACGCGGAATTCCTGCAATA
TCATACGCCAAATCGATCGTCATA -> CATACGCCAAATCGATCGTCATAA
ATCCCCTCTATTTACCAGCCCCCT -> TCCCCTCTATTTACCAGCCCCCTC
CTCGGTTAACTGTTTAATCAGCGA -> TCGGTTAACTGTTTAATCAGCGAT
TCGTGGATATAACCTAGCCCGTGG -> CGTGGATATAACCTAGCCCGTGGA
AGACCCTGAAGAAGACAATTCTCG -> GACCCTGAAGAAGACAATTCTCGC
CATGTGAACATGAACGGTGGAGTC -> ATGTGAACATGAACGGTGGAGTCA
TTGCAACATCGGATGTATTGATTT -> TGCAACATCGGATGTATTGATTTA
ATTCAACCGCCGAGTGTGTAGTGG -> TTCAACCGCCGAGTGTGTAGTGGT
CCCCCTCACGCGGAATTCCTGCAA -> CCCCTCACGCGGAATTCCTGCAAT
TGTCGTCTTCTGACAGGTTAGGTC -> GTCGTCTTCTGACAGGTTAGGTCA
ACGCCCGGGTAGGGCTACAAATGG -> CGCCCGGGTAGGGCTACAAATGGT
CGTCGGTAGCTGGTATGATTCATG -> GTCGGTAGCTGGTATGATTCATGA
GTGGGATAGCTGTCACGGTTGTGA -> TGGGATAGCTGTCACGGTTGTGAT
ATACCTTTTTTGAAACAAAATCTA -> TACCTTTTTTGAAACAAAATCTAA
CACAGAAATTCAACCGCCGAGTGT -> ACAGAAATTCAACCGCCGAGTGTG
AGTCTGTCCGGGATTCGGTCCACC -> GTCTGTCCGGGATTCGGTCCACCT
TTCCACAATTAGTCGTCCGTCCAG -> TCCACAATTAGTCGTCCGTCCAGC
ACGCATTGCGTGCAAATGCTAGTA -> CGCATTGCGTGCAAATGCTAGTAC
TTTTGCTTTCCCTCCCGTAAATCA -> TTTGCTTTCCCTCCCGTAAATCAG
TAGGTCATGGCTGGTGCCGGGGAT -> AGGTCATGGCTGGTGCCGGGGATG
CGAGACCAGGCGATTAACAAACTC -> GAGACCAGGCGATTAACAAACTCG
TGTCTGGAACCGCGCCGCCCTTCT -> GTCTGGAACCGCGCCGCCCTTCTA
GAACTGGCACATCGCGAAGGATTT -> AACTGGCACATCGCGAAGGATTTT
ATATTTGAACTGGCACATCGCGAA -> TATTTGAACTGGCACATCGCGAAG
GCGGCATGACTATAGGATCGTCGG -> CGGCATGACTATAGGATCGTCGGT
ACTGACACGAAGTCAAAGCTCTTG -> CTGACACGAAGTCAAAGCTCTTGA
AACGATTTTTTCTACAAACTGTCG -> ACGATTTTTTCTACAAACTGTCGT
CGATTAACCGCAGATCGTCGGGAA -> GATTAACCGCAGATCGTCGGGAAT
ACTCGGGGCCTCATGGCCGGTAGC -> CTCGGGGCCTCATGGCCGGTAGCG
CTCACAAATCCCCTCTATTTACCA -> TCACAAATCCCCTCTATTTACCAG
GTTAGACATGCCTCAGAAAACTCG -> TTAGACATGCCTCAGAAAACTCGG
TAGAGGAGTTAGACATGCCTCAGA -> AGAGGAGTTAGACATGCCTCAGAA
GTGGACCCATGGGCGTCGGATAAA -> TGGACCCATGGGCGTCGGATAAAC
GTAGGTAGTTCTTTAGCGCCTCGA -> TAGGTAGTTCTTTAGCGCCTCGAT
CCATTATCTCGGATATTCGGAGAA -> CATTATCTCGGATATTCGGAGAAG
CTCCCGTAAATCAGACTGCGACCG -> TCCCGTAAATCAGACTGCGACCGG
GTGTCCAGTGCTCCTAGTACTTGA -> TGTCCAGTGCTCCTAGTACTTGAA
TCGGATATTCGGAGAAGTAGTCCT -> CGGATATTCGGAGAAGTAGTCCTC
GACGGCGCAAGCGTCGTGGAGAAA -> ACGGCGCAAGCGTCGTGGAGAAAC
TCAATGAGTCTACCTACGAAGCAC -> CAATGAGTCTACCTACGAAGCACA
GGGCATACTGACACGAAGTCAAAG -> GGCATACTGACACGAAGTCAAAGC
TTTGGAACTCACTCTTGGATGAAT -> TTGGAACTCACTCTTGGATGAATC
GTCAGCCGCTACTTAGCTTTTTAC -> TCAGCCGCTACTTAGCTTTTTACT
ACTGGTCCGTGGGATAGCTGTCAC -> CTGGTCCGTGGGATAGCTGTCACG
TGTGTCGAGCGTGGTGCTTCTTAC -> GTGTCGAGCGTGGTGCTTCTTACG
ACGGGCGATGCTCCGGCCTACATT -> CGGGCGATGCTCCGGCCTACATTG
CATAGTCTGTCCGGGATTCGGTCC -> ATAGTCTGTCCGGGATTCGGTCCA
AATCGCCTACATTACGTAGGACTA -> ATCGCCTACATTACGTAGGACTAC
GACCCATGGGCGTCGGATAAACGG -> ACCCATGGGCGTCGGATAAACGGC
AGATCGAACCCACGCGATACGACA -> GATCGAACCCACGCGATACGACAG
CGGGCATACTGACACGAAGTCAAA -> GGGCATACTGACACGAAGTCAAAG
CTCGCATAACTCACTCGTTACGAT -> TCGCATAACTCACTCGTTACGATG
CCAGGAATGTGCAGAAAATACTTC -> CAGGAATGTGCAGAAAATACTTCA
CCACCTACCAGGGTCACTCACTGA -> CACCTACCAGGGTCACTCACTGAA
TGCTGCCACCAATTATATGGAACA -> GCTGCCACCAATTATATGGAACAC
CACTCAATGAGTCTACCTACGAAG -> ACTCAATGAGTCTACCTACGAAGC
CGATCGTCATAAGCTCTAGTTAGG -> GATCGTCATAAGCTCTAGTTAGGG
TGGTAGAGGAGTTAGACATGCCTC -> GGTAGAGGAGTTAGACATGCCTCA
AACAACAACGAGACCAGGCGATTA -> ACAACAACGAGACCAGGCGATTAA
AGGTCTAACTACTGTGACCATTAT -> GGTCTAACTACTGTGACCATTATC
TATACGACCTCCTAGATCTGAACA -> ATACGACCTCCTAGATCTGAACAA
ATTAACCGCAGATCGTCGGGAATT -> TTAACCGCAGATCGTCGGGAATTA
CCTCATGGCCGGTAGCGGGCCTTT -> CTCATGGCCGGTAGCGGGCCTTTA
CACAGGTCCACACATTTGGATCGA -> ACAGGTCCACACATTTGGATCGAC
ACTGTGGGAAGTGCCACTCAAGAG -> CTGTGGGAAGTGCCACTCAAGAGG
TTGTGACCATGTGAACATGAACGG -> TGTGACCATGTGAACATGAACGGT
GGTGCAGCCATGGCTCAGTTGTTT -> GTGCAGCCATGGCTCAGTTGTTTT
GCAACCGACACACACTGATGCGTG -> CAACCGACACACACTGATGCGTGG
GTACTTGAACAGGCAAAGATCGAA -> TACTTGAACAGGCAAAGATCGAAC
TGTTTAATCAGCGATACGGACAGG -> GTTTAATCAGCGATACGGACAGGG
CTCACTGAAGACTCATGACGGAGG -> TCACTGAAGACTCATGACGGAGGT
TGAAAACAGACGGCCTGTTGGGAT -> GAAAACAGACGGCCTGTTGGGATG
TCGTCGGTAGCTGGTATGATTCAT -> CGTCGGTAGCTGGTATGATTCATG
AAGCGTCGTGGAGAAACATGAACG -> AGCGTCGTGGAGAAACATGAACGA
GCTCCAGGAATGTGCAGAAAATAC -> CTCCAGGAATGTGCAGAAAATACT
CCGGTTAGGTAATCGAGCAATGCT -> CGGTTAGGTAATCGAGCAATGCTA
CAACACAGAAATTCAACCGCCGAG -> AACACAGAAATTCAACCGCCGAGT
ATTTATGACCGACTCGTGTTAAGA -> TTTATGACCGACTCGTGTTAAGAA
ACATGAACGATTTTTTCTACAAAC -> CATGAACGATTTTTTCTACAAACT
ACGCTCGGAAGAAACTGGTCCGTG -> CGCTCGGAAGAAACTGGTCCGTGG
GGCCCACTGTCATGCGGGCATACT -> GCCCACTGTCATGCGGGCATACTG
GAAAAACCTGGCGAAGCAGCGGCA -> AAAAACCTGGCGAAGCAGCGGCAT
AGACAGTCACTAGATAGACAATTT -> GACAGTCACTAGATAGACAATTTA
TGATTTATGACCGACTCGTGTTAA -> GATTTATGACCGACTCGTGTTAAG
ACTAGATAGACAATTTATACGACC -> CTAGATAGACAATTTATACGACCT
CTTGGTGATCCCGTAGTGCACATT -> TTGGTGATCCCGTAGTGCACATTA
GATTGCTAAGACCCTGAAGAAGAC -> ATTGCTAAGACCCTGAAGAAGACA
CATGGCCGGTAGCGGGCCTTTATC -> ATGGCCGGTAGCGGGCCTTTATCC
TAAGAAAAACCTGGCGAAGCAGCG -> AAGAAAAACCTGGCGAAGCAGCGG
TGAACAACAACGAGACCAGGCGAT -> GAACAACAACGAGACCAGGCGATT
GTGGATATAACCTAGCCCGTGGAC -> TGGATATAACCTAGCCCGTGGACC
TAGGATCGTCGGTAGCTGGTATGA -> AGGATCGTCGGTAGCTGGTATGAT
TGAATTAGAGATACTCTGGTAACC -> GAATTAGAGATACTCTGGTAACCT
TTACGCTCGGAAGAAACTGGTCCG -> TACGCTCGGAAGAAACTGGTCCGT
TGCTCAATCGCCTACATTACGTAG -> GCTCAATCGCCTACATTACGTAGG
GCCCACTGTCATGCGGGCATACTG -> CCCACTGTCATGCGGGCATACTGA
TTAACAAACTCGGTTAACTGTTTA -> TAACAAACTCGGTTAACTGTTTAA
ATATTGGAGACCTGAATTAGAGAT -> TATTGGAGACCTGAATTAGAGATA
TCTTGGTGATCCCGTAGTGCACAT -> CTTGGTGATCCCGTAGTGCACATT
GGTGGGTGCTCAATCGCCTACATT -> GTGGGTGCTCAATCGCCTACATTA
CCATGTTCGTGGATATAACCTAGC -> CATGTTCGTGGATATAACCTAGCC
GGAATTAACATAGTCTGTCCGGGA -> GAATTAACATAGTCTGTCCGGGAT
CTCTATATAACTTCCTTCATCTTG -> TCTATATAACTTCCTTCATCTTGG
AAACTCGAGTAATCTTGGTACAAC -> AACTCGAGTAATCTTGGTACAACG
AGCACAAGATTGGTGCAGCCATGG -> GCACAAGATTGGTGCAGCCATGGC
AGTGCCACTCAAGAGGGGTCTGAA -> GTGCCACTCAAGAGGGGTCTGAAC
TATTCGGAGAAGTAGTCCTCTCAC -> ATTCGGAGAAGTAGTCCTCTCACA
AGGGCGGTACTCTATATAACTTCC -> GGGCGGTACTCTATATAACTTCCT
CCGGGTAGGGCTACAAATGGTTTT -> CGGGTAGGGCTACAAATGGTTTTG
TCCGTGGGATAGCTGTCACGGTTG -> CCGTGGGATAGCTGTCACGGTTGT
ATACGCCCGGGTAGGGCTACAAAT -> TACGCCCGGGTAGGGCTACAAATG
GTCCGTCCAGCAGACCGAACAGCA -> TCCGTCCAGCAGACCGAACAGCAG
CCGGAGGGATCCGGCTGGGGTTGA -> CGGAGGGATCCGGCTGGGGTTGAC
GGATAAACGGCTGTCAGCCGCTAC -> GATAAACGGCTGTCAGCCGCTACT
CGGTTAGGTAATCGAGCAATGCTA -> GGTTAGGTAATCGAGCAATGCTAT
GAAAATACTTCAAGTTCCACAATT -> AAAATACTTCAAGTTCCACAATTA
GAAGCACAAGATTGGTGCAGCCAT -> AAGCACAAGATTGGTGCAGCCATG
ATGGTTTTGATTCACTGTGGGAAG -> TGGTTTTGATTCACTGTGGGAAGT
TGGGTGCTCAATCGCCTACATTAC -> GGGTGCTCAATCGCCTACATTACG
ATTCGGAGAAGTAGTCCTCTCACA -> TTCGGAGAAGTAGTCCTCTCACAG
CCTTTTTTGAAACAAAATCTAAGT -> CTTTTTTGAAACAAAATCTAAGTC
AAGACAATTCTCGCAGTGCTCCAG -> AGACAATTCTCGCAGTGCTCCAGG
ACACGTTCCCTCGAAACCCACTCA -> CACGTTCCCTCGAAACCCACTCAA
TGGCTCAGTTGTTTTACTTCATCT -> GGCTCAGTTGTTTTACTTCATCTC
GCAAGCGTCGTGGAGAAACATGAA -> CAAGCGTCGTGGAGAAACATGAAC
CGGGATGAATGATTATGGGTCGTA -> GGGATGAATGATTATGGGTCGTAT
GTCTGGAACCGCGCCGCCCTTCTA -> TCTGGAACCGCGCCGCCCTTCTAG
TGTAAGGTAGCCACAGACGCCTAT -> GTAAGGTAGCCACAGACGCCTATA
CGTCGTAGGTAGTTCTTTAGCGCC -> GTCGTAGGTAGTTCTTTAGCGCCT
GCTTTCCCTCCCGTAAATCAGACT -> CTTTCCCTCCCGTAAATCAGACTG
AGCGGCATGACTATAGGATCGTCG -> GCGGCATGACTATAGGATCGTCGG
CGGTCCACCTACCAGGGTCACTCA -> GGTCCACCTACCAGGGTCACTCAC
AACTGTTTAATCAGCGATACGGAC -> ACTGTTTAATCAGCGATACGGACA
TACGGACAGGGCGGTACTCTATAT -> ACGGACAGGGCGGTACTCTATATA
GAATTAACATAGTCTGTCCGGGAT -> AATTAACATAGTCTGTCCGGGATT
GCTCCTAGTACTTGAACAGGCAAA -> CTCCTAGTACTTGAACAGGCAAAG
CGAAGCACAAGATTGGTGCAGCCA -> GAAGCACAAGATTGGTGCAGCCAT
TAGACAATTTATACGACCTCCTAG -> AGACAATTTATACGACCTCCTAGA
ATACTCTGGTAACCTCCATCTACC -> TACTCTGGTAACCTCCATCTACCG
AGGTAATCGAGCAATGCTATTCCC -> GGTAATCGAGCAATGCTATTCCCA
CATGCCTCAGAAAACTCGGGGCCT -> ATGCCTCAGAAAACTCGGGGCCTC
AATATTGGAGACCTGAATTAGAGA -> ATATTGGAGACCTGAATTAGAGAT
TGTTTTACTTCATCTCAGCGAGTG -> GTTTTACTTCATCTCAGCGAGTGA
GCACCTTCTGCTGCCACCAATTAT -> CACCTTCTGCTGCCACCAATTATA
GTATGATTCATGATATAATTCTGC -> TATGATTCATGATATAATTCTGCC
GACAGATAGACAGTCACTAGATAG -> ACAGATAGACAGTCACTAGATAGA
GGAGGTATTTTTTTGCTTTCCCTC -> GAGGTATTTTTTTGCTTTCCCTCC
CGCCTACATTACGTAGGACTACCG -> GCCTACATTACGTAGGACTACCGC
ATGCGGGCATACTGACACGAAGTC -> TGCGGGCATACTGACACGAAGTCA
TGACACGAAGTCAAAGCTCTTGAT -> GACACGAAGTCAAAGCTCTTGATT
CACACTGATGCGTGGAGGCCCACT -> ACACTGATGCGTGGAGGCCCACTG
GTCCACACATTTGGATCGACCGAT -> TCCACACATTTGGATCGACCGATT
CGGGCGATGCTCCGGCCTACATTG -> GGGCGATGCTCCGGCCTACATTGC
CGGTAGCTGGTATGATTCATGATA -> GGTAGCTGGTATGATTCATGATAT
TCGGATGTATTGATTTATCATTCT -> CGGATGTATTGATTTATCATTCTA
TGGAACACGCATTGCGTGCAAATG -> GGAACACGCATTGCGTGCAAATGC
TCTACCGTGTGTCGAGCGTGGTGC -> CTACCGTGTGTCGAGCGTGGTGCT
GTTTAATCAGCGATACGGACAGGG -> TTTAATCAGCGATACGGACAGGGC
CGCGTTGTCTCGCATAACTCACTC -> GCGTTGTCTCGCATAACTCACTCG
CTCGTGTTAAGAAAAACCTGGCGA -> TCGTGTTAAGAAAAACCTGGCGAA
GTCCGTGGGATAGCTGTCACGGTT -> TCCGTGGGATAGCTGTCACGGTTG
ACACACTGATGCGTGGAGGCCCAC -> CACACTGATGCGTGGAGGCCCACT
GAGTCTACCTACGAAGCACAAGAT -> AGTCTACCTACGAAGCACAAGATT
AGGAGGTTACAACACAGAAATTCA -> GGAGGTTACAACACAGAAATTCAA
GTGGGAAGTGCCACTCAAGAGGGG -> TGGGAAGTGCCACTCAAGAGGGGT
CGATTAACAAACTCGGTTAACTGT -> GATTAACAAACTCGGTTAACTGTT
GGATGAATGATTATGGGTCGTATG -> GATGAATGATTATGGGTCGTATGG
GTCACGGTTGTGATATACCTTTTT -> TCACGGTTGTGATATACCTTTTTT
AATTGTGACCATGTGAACATGAAC -> ATTGTGACCATGTGAACATGAACG
TGCTCCTAGTACTTGAACAGGCAA -> GCTCCTAGTACTTGAACAGGCAAA
TGCTTTCCCTCCCGTAAATCAGAC -> GCTTTCCCTCCCGTAAATCAGACT
GAACATGAACGGTGGAGTCATTTG -> AACATGAACGGTGGAGTCATTTGT
ATTATGGGTCGTATGGAAGGATGC -> TTATGGGTCGTATGGAAGGATGCA
GTTCCCTCGAAACCCACTCAATGA -> TTCCCTCGAAACCCACTCAATGAG
ACAACACAGAAATTCAACCGCCGA -> CAACACAGAAATTCAACCGCCGAG
CGGAGGGATCCGGCTGGGGTTGAC -> GGAGGGATCCGGCTGGGGTTGACC
CCTCTATTTACCAGCCCCCTCACG -> CTCTATTTACCAGCCCCCTCACGC
AGTACTTGAACAGGCAAAGATCGA -> GTACTTGAACAGGCAAAGATCGAA
CCGGCTGGGGTTGACCACAACCCC -> CGGCTGGGGTTGACCACAACCCCT
GATGAATGATTATGGGTCGTATGG -> ATGAATGATTATGGGTCGTATGGA
GGATGTAAGGAGGTTACAACACAG -> GATGTAAGGAGGTTACAACACAGA
TTTATCCCACCACAGGCGCTCGAT -> TTATCCCACCACAGGCGCTCGATA
CAAGTTCCACAATTAGTCGTCCGT -> AAGTTCCACAATTAGTCGTCCGTC
TAGATAGACAATTTATACGACCTC -> AGATAGACAATTTATACGACCTCC
AATTCAACCGCCGAGTGTGTAGTG -> ATTCAACCGCCGAGTGTGTAGTGG
ATCTTCTCACAAATCCCCTCTATT -> TCTTCTCACAAATCCCCTCTATTT
TTTTTGAAACAAAATCTAAGTCAT -> TTTTGAAACAAAATCTAAGTCATA
GTAGTGCACATTACGTAAACTCGA -> TAGTGCACATTACGTAAACTCGAG
CAATGCTATTCCCATGTTCGTGGA -> AATGCTATTCCCATGTTCGTGGAT
TTCTGCTGCCACCAATTATATGGA -> TCTGCTGCCACCAATTATATGGAA
GTTAACTGTTTAATCAGCGATACG -> TTAACTGTTTAATCAGCGATACGG
TCGTAGGTAGTTCTTTAGCGCCTC -> CGTAGGTAGTTCTTTAGCGCCTCG
GGGCCTCATGGCCGGTAGCGGGCC -> GGCCTCATGGCCGGTAGCGGGCCT
GCAATGCTATTCCCATGTTCGTGG -> CAATGCTATTCCCATGTTCGTGGA
AACACAGAAATTCAACCGCCGAGT -> ACACAGAAATTCAACCGCCGAGTG
TCGCAGTGCTCCAGGAATGTGCAG -> CGCAGTGCTCCAGGAATGTGCAGA
AACACGCATTGCGTGCAAATGCTA -> ACACGCATTGCGTGCAAATGCTAG
TGATTTATCATTCTATGCGTAGCT -> GATTTATCATTCTATGCGTAGCTA
AAGGAGGTTACAACACAGAAATTC -> AGGAGGTTACAACACAGAAATTCA
AACAACGAGACCAGGCGATTAACA -> ACAACGAGACCAGGCGATTAACAA
ACGGTTGTGATATACCTTTTTTGA -> CGGTTGTGATATACCTTTTTTGAA
CTTGGATGAATCCCACCAGCGCAC -> TTGGATGAATCCCACCAGCGCACC
TCCCACCACAGGCGCTCGATACGC -> CCCACCACAGGCGCTCGATACGCC
CTACGAAGCACAAGATTGGTGCAG -> TACGAAGCACAAGATTGGTGCAGC
GTCGGGAATTAACATAGTCTGTCC -> TCGGGAATTAACATAGTCTGTCCG
ATAGACAGTCACTAGATAGACAAT -> TAGACAGTCACTAGATAGACAATT
CCCGGGTAGGGCTACAAATGGTTT -> CCGGGTAGGGCTACAAATGGTTTT
GCATAACTCACTCGTTACGATGAA -> CATAACTCACTCGTTACGATGAAA
TCTCGCATAACTCACTCGTTACGA -> CTCGCATAACTCACTCGTTACGAT
TCTAAGTCATACGCCAAATCGATC -> CTAAGTCATACGCCAAATCGATCG
GATTGCAACATCGGATGTATTGAT -> ATTGCAACATCGGATGTATTGATT
CGGGATTCGGTCCACCTACCAGGG -> GGGATTCGGTCCACCTACCAGGGT
CGGCTGGGGTTGACCACAACCCCT -> GGCTGGGGTTGACCACAACCCCTG
ACGGCGCAAGCGTCGTGGAGAAAC -> CGGCGCAAGCGTCGTGGAGAAACA
GGAGGCCCACTGTCATGCGGGCAT -> GAGGCCCACTGTCATGCGGGCATA
CGTTCCCTCGAAACCCACTCAATG -> GTTCCCTCGAAACCCACTCAATGA
GCCTACATTACGTAGGACTACCGC -> CCTACATTACGTAGGACTACCGCA
GTAGTTCTTTAGCGCCTCGATTGC -> TAGTTCTTTAGCGCCTCGATTGCA
CCTCAGAAAACTCGGGGCCTCATG -> CTCAGAAAACTCGGGGCCTCATGG
GATTATGGGTCGTATGGAAGGATG -> ATTATGGGTCGTATGGAAGGATGC
TTCTTACGCTCGGAAGAAACTGGT -> TCTTACGCTCGGAAGAAACTGGTC
GGTACAACGATCCGGGATGAATGA -> GTACAACGATCCGGGATGAATGAT
TTTTTACTGCCGGAGGGATCCGGC -> TTTTACTGCCGGAGGGATCCGGCT
TCTTCTCACAAATCCCCTCTATTT -> CTTCTCACAAATCCCCTCTATTTA
TAGGAGACAGGGATTGGGTGGGTG -> AGGAGACAGGGATTGGGTGGGTGC
AGGCAAAGATCGAACCCACGCGAT -> GGCAAAGATCGAACCCACGCGATA
GTGGAGGCCCACTGTCATGCGGGC -> TGGAGGCCCACTGTCATGCGGGCA
TCGTGTAAGGTAGCCACAGACGCC -> CGTGTAAGGTAGCCACAGACGCCT
ACTCTTGGATGAATCCCACCAGCG -> CTCTTGGATGAATCCCACCAGCGC
GGAGTTAGACATGCCTCAGAAAAC -> GAGTTAGACATGCCTCAGAAAACT
TAATCGAGCAATGCTATTCCCATG -> AATCGAGCAATGCTATTCCCATGT
ATTGATTTATCATTCTATGCGTAG -> TTGATTTATCATTCTATGCGTAGC
CTGGTATGATTCATGATATAATTC -> TGGTATGATTCATGATATAATTCT
CCCGTGGACCCATGGGCGTCGGAT -> CCGTGGACCCATGGGCGTCGGATA
ATTCATGATATAATTCTGCCGCAG -> TTCATGATATAATTCTGCCGCAGA
ACCAGCGCACCTTCTGCTGCCACC -> CCAGCGCACCTTCTGCTGCCACCA
GAACCGCGCCGCCCTTCTAGGAGA -> AACCGCGCCGCCCTTCTAGGAGAC
CTCTCACAGGTCCACACATTTGGA -> TCTCACAGGTCCACACATTTGGAT
TTGAGGTCTAACTACTGTGACCAT -> TGAGGTCTAACTACTGTGACCATT
AACCGCAGATCGTCGGGAATTAAC -> ACCGCAGATCGTCGGGAATTAACA
TGGGTGGGTGCTCAATCGCCTACA -> GGGTGGGTGCTCAATCGCCTACAT
CGTTGAGGTCTAACTACTGTGACC -> GTTGAGGTCTAACTACTGTGACCA
TGTTAAGAAAAACCTGGCGAAGCA -> GTTAAGAAAAACCTGGCGAAGCAG
CGAGTGTGTAGTGGTAGAGGAGTT -> GAGTGTGTAGTGGTAGAGGAGTTA
CACCTACCAGGGTCACTCACTGAA -> ACCTACCAGGGTCACTCACTGAAG
AAACGGCTGTCAGCCGCTACTTAG -> AACGGCTGTCAGCCGCTACTTAGC
ACCGTGTGTCGAGCGTGGTGCTTC -> CCGTGTGTCGAGCGTGGTGCTTCT
CCTTCTAGGAGACAGGGATTGGGT -> CTTCTAGGAGACAGGGATTGGGTG
GCGATACGACAGATAGACAGTCAC -> CGATACGACAGATAGACAGTCACT
TGCAGAAAATACTTCAAGTTCCAC -> GCAGAAAATACTTCAAGTTCCACA
ATAGACGCCGTCGTAGGTAGTTCT -> TAGACGCCGTCGTAGGTAGTTCTT
CAGATCGTCGGGAATTAACATAGT -> AGATCGTCGGGAATTAACATAGTC
TGCTCCGGCCTACATTGCCGGGGT -> GCTCCGGCCTACATTGCCGGGGTG
AGTAATCTTGGTACAACGATCCGG -> GTAATCTTGGTACAACGATCCGGG
ATGAATCCCACCAGCGCACCTTCT -> TGAATCCCACCAGCGCACCTTCTG
TGATTATGGGTCGTATGGAAGGAT -> GATTATGGGTCGTATGGAAGGATG
ATGACTATAGGATCGTCGGTAGCT -> TGACTATAGGATCGTCGGTAGCTG
GGCATGACTATAGGATCGTCGGTA -> GCATGACTATAGGATCGTCGGTAG
TAGCTACGGGCGATGCTCCGGCCT -> AGCTACGGGCGATGCTCCGGCCTA
AGACTGCGACCGGTTAGGTAATCG -> GACTGCGACCGGTTAGGTAATCGA
CGTGGACCCATGGGCGTCGGATAA -> GTGGACCCATGGGCGTCGGATAAA
GAGGTTACAACACAGAAATTCAAC -> AGGTTACAACACAGAAATTCAACC
CGACCGATTAACCGCAGATCGTCG -> GACCGATTAACCGCAGATCGTCGG
TCATTCTATGCGTAGCTACGGGCG -> CATTCTATGCGTAGCTACGGGCGA
GCGTGGTGCTTCTTACGCTCGGAA -> CGTGGTGCTTCTTACGCTCGGAAG
TCATCTTGGTGATCCCGTAGTGCA -> CATCTTGGTGATCCCGTAGTGCAC
CGTGTAAGGTAGCCACAGACGCCT -> GTGTAAGGTAGCCACAGACGCCTA
CTCTAGTTAGGGCGGATTTGGAAC -> TCTAGTTAGGGCGGATTTGGAACT
TTGGGTGGGTGCTCAATCGCCTAC -> TGGGTGGGTGCTCAATCGCCTACA
GGTTACAACACAGAAATTCAACCG -> GTTACAACACAGAAATTCAACCGC
ATGAACGGTGGAGTCATTTGTCTG -> TGAACGGTGGAGTCATTTGTCTGG
CAAGATTGGTGCAGCCATGGCTCA -> AAGATTGGTGCAGCCATGGCTCAG
GACCATTATCTCGGATATTCGGAG -> ACCATTATCTCGGATATTCGGAGA
GCGATGCTCCGGCCTACATTGCCG -> CGATGCTCCGGCCTACATTGCCGG
CGAGTAATCTTGGTACAACGATCC -> GAGTAATCTTGGTACAACGATCCG
TTTATACGACCTCCTAGATCTGAA -> TTATACGACCTCCTAGATCTGAAC
CCGCGACGGCGCAAGCGTCGTGGA -> CGCGACGGCGCAAGCGTCGTGGAG
GCTACTTAGCTTTTTACTGCCGGA -> CTACTTAGCTTTTTACTGCCGGAG
GATTCGCGATCGCGCGTTGTCTCG -> ATTCGCGATCGCGCGTTGTCTCGC
AACGTTGTCGTGTAAGGTAGCCAC -> ACGTTGTCGTGTAAGGTAGCCACA
CTGAAGAAGACAATTCTCGCAGTG -> TGAAGAAGACAATTCTCGCAGTGC
CCTTCATCTTGGTGATCCCGTAGT -> CTTCATCTTGGTGATCCCGTAGTG
TGGGGTTGACCACAACCCCTGCCG -> GGGGTTGACCACAACCCCTGCCGG
GCCGTCGTAGGTAGTTCTTTAGCG -> CCGTCGTAGGTAGTTCTTTAGCGC
CAAGAGGGGTCTGAACGTTGAGGT -> AAGAGGGGTCTGAACGTTGAGGTC
ACTCGAGTAATCTTGGTACAACGA -> CTCGAGTAATCTTGGTACAACGAT
GTCACTCACTGAAGACTCATGACG -> TCACTCACTGAAGACTCATGACGG
CGGCCTACATTGCCGGGGTGTGTC -> GGCCTACATTGCCGGGGTGTGTCC
CCGTCCAGCAGACCGAACAGCAGA -> CGTCCAGCAGACCGAACAGCAGAT
AATGAGTCTACCTACGAAGCACAA -> ATGAGTCTACCTACGAAGCACAAG
TAAGGTAGCCACAGACGCCTATAT -> AAGGTAGCCACAGACGCCTATATT
GGTAGCCACAGACGCCTATATTTG -> GTAGCCACAGACGCCTATATTTGA
ATGTTCGTGGATATAACCTAGCCC -> TGTTCGTGGATATAACCTAGCCCG
GCAGACCGAACAGCAGATCTTCTC -> CAGACCGAACAGCAGATCTTCTCA
GGATCGTCGGTAGCTGGTATGATT -> GATCGTCGGTAGCTGGTATGATTC
CATTTGGATCGACCGATTAACCGC -> ATTTGGATCGACCGATTAACCGCA
GAAGGATGCAGACACGTTCCCTCG -> AAGGATGCAGACACGTTCCCTCGA
TTTGAAACAAAATCTAAGTCATAC -> TTGAAACAAAATCTAAGTCATACG
CATAACTCACTCGTTACGATGAAA -> ATAACTCACTCGTTACGATGAAAA
GGTCCGTGGGATAGCTGTCACGGT -> GTCCGTGGGATAGCTGTCACGGTT
TTGTGATATACCTTTTTTGAAACA -> TGTGATATACCTTTTTTGAAACAA
AGTCATACGCCAAATCGATCGTCA -> GTCATACGCCAAATCGATCGTCAT
CGCGGAATTCCTGCAATATTGGAG -> GCGGAATTCCTGCAATATTGGAGA
ACCCTGAAGAAGACAATTCTCGCA -> CCCTGAAGAAGACAATTCTCGCAG
ATGAGTCTACCTACGAAGCACAAG -> TGAGTCTACCTACGAAGCACAAGA
ACTCACTCTTGGATGAATCCCACC -> CTCACTCTTGGATGAATCCCACCA
AGACACGTTCCCTCGAAACCCACT -> GACACGTTCCCTCGAAACCCACTC
GGCAAAGATCGAACCCACGCGATA -> GCAAAGATCGAACCCACGCGATAC
GAGTGTGTAGTGGTAGAGGAGTTA -> AGTGTGTAGTGGTAGAGGAGTTAG
TACTTAGCTTTTTACTGCCGGAGG -> ACTTAGCTTTTTACTGCCGGAGGG
ACTCGTGTTAAGAAAAACCTGGCG -> CTCGTGTTAAGAAAAACCTGGCGA
TAAACGGCTGTCAGCCGCTACTTA -> AAACGGCTGTCAGCCGCTACTTAG
CAAATGCTAGTACTTACAGGGTTC -> AAATGCTAGTACTTACAGGGTTCC
GATTAACCGCAGATCGTCGGGAAT -> ATTAACCGCAGATCGTCGGGAATT
GGGATAGCTGTCACGGTTGTGATA -> GGATAGCTGTCACGGTTGTGATAT
ATTTATACGACCTCCTAGATCTGA -> TTTATACGACCTCCTAGATCTGAA
TATGATTCATGATATAATTCTGCC -> ATGATTCATGATATAATTCTGCCG
ACGTAAACTCGAGTAATCTTGGTA -> CGTAAACTCGAGTAATCTTGGTAC
GACCATGTGAACATGAACGGTGGA -> ACCATGTGAACATGAACGGTGGAG
ACTTCAAGTTCCACAATTAGTCGT -> CTTCAAGTTCCACAATTAGTCGTC
CTGCAATATTGGAGACCTGAATTA -> TGCAATATTGGAGACCTGAATTAG
CACAAATCCCCTCTATTTACCAGC -> ACAAATCCCCTCTATTTACCAGCC
CTCGATTGCAACATCGGATGTATT -> TCGATTGCAACATCGGATGTATTG
GATTTTTTCTACAAACTGTCGTCT -> ATTTTTTCTACAAACTGTCGTCTT
ACTCTGGTAACCTCCATCTACCGT -> CTCTGGTAACCTCCATCTACCGTG
TAGGGCGGATTTGGAACTCACTCT -> AGGGCGGATTTGGAACTCACTCTT
CCCCTGCCGGTGATTGCTAAGACC -> CCCTGCCGGTGATTGCTAAGACCC
TTCATCTTGGTGATCCCGTAGTGC -> TCATCTTGGTGATCCCGTAGTGCA
GACATGCCTCAGAAAACTCGGGGC -> ACATGCCTCAGAAAACTCGGGGCC
GTCGGTAGCTGGTATGATTCATGA -> TCGGTAGCTGGTATGATTCATGAT
ACCGCGCCGCCCTTCTAGGAGACA -> CCGCGCCGCCCTTCTAGGAGACAG
GCCGAGTGTGTAGTGGTAGAGGAG -> CCGAGTGTGTAGTGGTAGAGGAGT
CAGTCACTAGATAGACAATTTATA -> AGTCACTAGATAGACAATTTATAC
CCTCCTAGATCTGAACAACAACGA -> CTCCTAGATCTGAACAACAACGAG
AACAGCAGATCTTCTCACAAATCC -> ACAGCAGATCTTCTCACAAATCCC
CTAGTTAGGGCGGATTTGGAACTC -> TAGTTAGGGCGGATTTGGAACTCA
TCCACAATTAGTCGTCCGTCCAGC -> CCACAATTAGTCGTCCGTCCAGCA
CAATTAGTCGTCCGTCCAGCAGAC -> AATTAGTCGTCCGTCCAGCAGACC
GCCGGTGATTGCTAAGACCCTGAA -> CCGGTGATTGCTAAGACCCTGAAG
CTGTTGGGATGTAAGGAGGTTACA -> TGTTGGGATGTAAGGAGGTTACAA
CGTAGGACTACCGCAACCGACACA -> GTAGGACTACCGCAACCGACACAC
TTTCTACAAACTGTCGTCTTCTGA -> TTCTACAAACTGTCGTCTTCTGAC
GCCAAATCGATCGTCATAAGCTCT -> CCAAATCGATCGTCATAAGCTCTA
TCGGGAATTAACATAGTCTGTCCG -> CGGGAATTAACATAGTCTGTCCGG
CGACCGGTTAGGTAATCGAGCAAT -> GACCGGTTAGGTAATCGAGCAATG
ACTCATGACGGAGGTATTTTTTTG -> CTCATGACGGAGGTATTTTTTTGC
TATGGAAGGATGCAGACACGTTCC -> ATGGAAGGATGCAGACACGTTCCC
CACGCATTGCGTGCAAATGCTAGT -> ACGCATTGCGTGCAAATGCTAGTA
GCGCACCTTCTGCTGCCACCAATT -> CGCACCTTCTGCTGCCACCAATTA
AGCTCTAGTTAGGGCGGATTTGGA -> GCTCTAGTTAGGGCGGATTTGGAA
GCGCCGCCCTTCTAGGAGACAGGG -> CGCCGCCCTTCTAGGAGACAGGGA
CAGGTCCACACATTTGGATCGACC -> AGGTCCACACATTTGGATCGACCG
CAAGCGTCGTGGAGAAACATGAAC -> AAGCGTCGTGGAGAAACATGAACG
TCATGGCCGGTAGCGGGCCTTTAT -> CATGGCCGGTAGCGGGCCTTTATC
TTGATTCACTGTGGGAAGTGCCAC -> TGATTCACTGTGGGAAGTGCCACT
TGGCACATCGCGAAGGATTTTTTA -> GGCACATCGCGAAGGATTTTTTAT
TTGATTTATCATTCTATGCGTAGC -> TGATTTATCATTCTATGCGTAGCT
GTAGTGGTAGAGGAGTTAGACATG -> TAGTGGTAGAGGAGTTAGACATGC
AGTAATAGACGCCGTCGTAGGTAG -> GTAATAGACGCCGTCGTAGGTAGT
CGCAACCGACACACACTGATGCGT -> GCAACCGACACACACTGATGCGTG
TCTACAAACTGTCGTCTTCTGACA -> CTACAAACTGTCGTCTTCTGACAG
CCGTGGGATAGCTGTCACGGTTGT -> CGTGGGATAGCTGTCACGGTTGTG
TTGGGATGTAAGGAGGTTACAACA -> TGGGATGTAAGGAGGTTACAACAC
TTCTAGGAGACAGGGATTGGGTGG -> TCTAGGAGACAGGGATTGGGTGGG
AGTTCCACAATTAGTCGTCCGTCC -> GTTCCACAATTAGTCGTCCGTCCA
TCTACCTACGAAGCACAAGATTGG -> CTACCTACGAAGCACAAGATTGGT
GGAATGTGCAGAAAATACTTCAAG -> GAATGTGCAGAAAATACTTCAAGT
AGCGTGGTGCTTCTTACGCTCGGA -> GCGTGGTGCTTCTTACGCTCGGAA
GGACTACCGCAACCGACACACACT -> GACTACCGCAACCGACACACACTG
GAACCCACGCGATACGACAGATAG -> AACCCACGCGATACGACAGATAGA
GGTTTTGATTCACTGTGGGAAGTG -> GTTTTGATTCACTGTGGGAAGTGC
AAGTGCCACTCAAGAGGGGTCTGA -> AGTGCCACTCAAGAGGGGTCTGAA
GTTAAGAAAAACCTGGCGAAGCAG -> TTAAGAAAAACCTGGCGAAGCAGC
TGCCACCAATTATATGGAACACGC -> GCCACCAATTATATGGAACACGCA
TACTGACACGAAGTCAAAGCTCTT -> ACTGACACGAAGTCAAAGCTCTTG
GAGTGATTCGCGATCGCGCGTTGT -> AGTGATTCGCGATCGCGCGTTGTC
ATAACCTAGCCCGTGGACCCATGG -> TAACCTAGCCCGTGGACCCATGGG
GGCGTCGGATAAACGGCTGTCAGC -> GCGTCGGATAAACGGCTGTCAGCC
CAAACTGTCGTCTTCTGACAGGTT -> AAACTGTCGTCTTCTGACAGGTTA
AAATGCTAGTACTTACAGGGTTCC -> AATGCTAGTACTTACAGGGTTCCC
CAACCGACACACACTGATGCGTGG -> AACCGACACACACTGATGCGTGGA
GCCGGTAGCGGGCCTTTATCCCAC -> CCGGTAGCGGGCCTTTATCCCACC
TGACAGGTTAGGTCATGGCTGGTG -> GACAGGTTAGGTCATGGCTGGTGC
TCCTCTCACAGGTCCACACATTTG -> CCTCTCACAGGTCCACACATTTGG
ACTCGTTACGATGAAAACAGACGG -> CTCGTTACGATGAAAACAGACGGC
AGGCCCACTGTCATGCGGGCATAC -> GGCCCACTGTCATGCGGGCATACT
ATTTTTTATCGACCAATTGTGACC -> TTTTTTATCGACCAATTGTGACCA
ACGTTCCCTCGAAACCCACTCAAT -> CGTTCCCTCGAAACCCACTCAATG
CGAGTGATTCGCGATCGCGCGTTG -> GAGTGATTCGCGATCGCGCGTTGT
TCTAGGAGACAGGGATTGGGTGGG -> CTAGGAGACAGGGATTGGGTGGGT
GGCGCAAGCGTCGTGGAGAAACAT -> GCGCAAGCGTCGTGGAGAAACATG
GGCTGTCAGCCGCTACTTAGCTTT -> GCTGTCAGCCGCTACTTAGCTTTT
GAAGCAGCGGCATGACTATAGGAT -> AAGCAGCGGCATGACTATAGGATC
AATCGATCGTCATAAGCTCTAGTT -> ATCGATCGTCATAAGCTCTAGTTA
GCTCAGTTGTTTTACTTCATCTCA -> CTCAGTTGTTTTACTTCATCTCAG
TGCCACTCAAGAGGGGTCTGAACG -> GCCACTCAAGAGGGGTCTGAACGT
ATCGTCGGGAATTAACATAGTCTG -> TCGTCGGGAATTAACATAGTCTGT
GTTGTCGTGTAAGGTAGCCACAGA -> TTGTCGTGTAAGGTAGCCACAGAC
TTCCTTCATCTTGGTGATCCCGTA -> TCCTTCATCTTGGTGATCCCGTAG
TTGCTTTCCCTCCCGTAAATCAGA -> TGCTTTCCCTCCCGTAAATCAGAC
CTAACTACTGTGACCATTATCTCG -> TAACTACTGTGACCATTATCTCGG
GGCCTGTTGGGATGTAAGGAGGTT -> GCCTGTTGGGATGTAAGGAGGTTA
TTCTGACAGGTTAGGTCATGGCTG -> TCTGACAGGTTAGGTCATGGCTGG
TCTTGATTTATGACCGACTCGTGT -> CTTGATTTATGACCGACTCGTGTT
GACTCGTGTTAAGAAAAACCTGGC -> ACTCGTGTTAAGAAAAACCTGGCG
CTACCTACGAAGCACAAGATTGGT -> TACCTACGAAGCACAAGATTGGTG
CTTGGTACAACGATCCGGGATGAA -> TTGGTACAACGATCCGGGATGAAT
TCCCGTAGTGCACATTACGTAAAC -> CCCGTAGTGCACATTACGTAAACT
TGCCGGTGATTGCTAAGACCCTGA -> GCCGGTGATTGCTAAGACCCTGAA
GCGTCGGATAAACGGCTGTCAGCC -> CGTCGGATAAACGGCTGTCAGCCG
CTTACAGGGTTCCCGCGACGGCGC -> TTACAGGGTTCCCGCGACGGCGCA
TACTTCATCTCAGCGAGTGATTCG -> ACTTCATCTCAGCGAGTGATTCGC
GACAGGGATTGGGTGGGTGCTCAA -> ACAGGGATTGGGTGGGTGCTCAAT
GCCACCAATTATATGGAACACGCA -> CCACCAATTATATGGAACACGCAT
GTTAGGTCATGGCTGGTGCCGGGG -> TTAGGTCATGGCTGGTGCCGGGGA
ACCGATTAACCGCAGATCGTCGGG -> CCGATTAACCGCAGATCGTCGGGA
AATGTGCAGAAAATACTTCAAGTT -> ATGTGCAGAAAATACTTCAAGTTC
CCCACCAGCGCACCTTCTGCTGCC -> CCACCAGCGCACCTTCTGCTGCCA
CTGGTCCGTGGGATAGCTGTCACG -> TGGTCCGTGGGATAGCTGTCACGG
ACCGCCGAGTGTGTAGTGGTAGAG -> CCGCCGAGTGTGTAGTGGTAGAGG
CCTGGCGAAGCAGCGGCATGACTA -> CTGGCGAAGCAGCGGCATGACTAT
GACTCATGACGGAGGTATTTTTTT -> ACTCATGACGGAGGTATTTTTTTG
TCATTTGTCTGGAACCGCGCCGCC -> CATTTGTCTGGAACCGCGCCGCCC
ATACGACAGATAGACAGTCACTAG -> TACGACAGATAGACAGTCACTAGA
TCAATCGCCTACATTACGTAGGAC -> CAATCGCCTACATTACGTAGGACT
CTCAGTTGTTTTACTTCATCTCAG -> TCAGTTGTTTTACTTCATCTCAGC
GCGTGCAAATGCTAGTACTTACAG -> CGTGCAAATGCTAGTACTTACAGG
ATGAACGATTTTTTCTACAAACTG -> TGAACGATTTTTTCTACAAACTGT
CCACCAATTATATGGAACACGCAT -> CACCAATTATATGGAACACGCATT
AAACATGAACGATTTTTTCTACAA -> AACATGAACGATTTTTTCTACAAA
GTCGTAGGTAGTTCTTTAGCGCCT -> TCGTAGGTAGTTCTTTAGCGCCTC
TAGCGGGCCTTTATCCCACCACAG -> AGCGGGCCTTTATCCCACCACAGG
TCCCCTCTATTTACCAGCCCCCTC -> CCCCTCTATTTACCAGCCCCCTCA
GGACCCATGGGCGTCGGATAAACG -> GACCCATGGGCGTCGGATAAACGG
TACGTAAACTCGAGTAATCTTGGT -> ACGTAAACTCGAGTAATCTTGGTA
CACTCACTGAAGACTCATGACGGA -> ACTCACTGAAGACTCATGACGGAG
GACAATTCTCGCAGTGCTCCAGGA -> ACAATTCTCGCAGTGCTCCAGGAA
CGTGGGATAGCTGTCACGGTTGTG -> GTGGGATAGCTGTCACGGTTGTGA
GCCACAGACGCCTATATTTGAACT -> CCACAGACGCCTATATTTGAACTG
ACAGCAGATCTTCTCACAAATCCC -> CAGCAGATCTTCTCACAAATCCCC
GATTTATGACCGACTCGTGTTAAG -> ATTTATGACCGACTCGTGTTAAGA
CGAAGTCAAAGCTCTTGATTTATG -> GAAGTCAAAGCTCTTGATTTATGA
CAGGGCGGTACTCTATATAACTTC -> AGGGCGGTACTCTATATAACTTCC
GCTATTCCCATGTTCGTGGATATA -> CTATTCCCATGTTCGTGGATATAA
CTGGTAACCTCCATCTACCGTGTG -> TGGTAACCTCCATCTACCGTGTGT
ACAAACTCGGTTAACTGTTTAATC -> CAAACTCGGTTAACTGTTTAATCA
GACAGGGCGGTACTCTATATAACT -> ACAGGGCGGTACTCTATATAACTT
CGTTGTCTCGCATAACTCACTCGT -> GTTGTCTCGCATAACTCACTCGTT
GGATAGCTGTCACGGTTGTGATAT -> GATAGCTGTCACGGTTGTGATATA
GGGTCGTATGGAAGGATGCAGACA -> GGTCGTATGGAAGGATGCAGACAC
CTGAATTAGAGATACTCTGGTAAC -> TGAATTAGAGATACTCTGGTAACC
GTAGGGCTACAAATGGTTTTGATT -> TAGGGCTACAAATGGTTTTGATTC
GCGATCGCGCGTTGTCTCGCATAA -> CGATCGCGCGTTGTCTCGCATAAC
TAGTGCACATTACGTAAACTCGAG -> AGTGCACATTACGTAAACTCGAGT
TTGTTTTACTTCATCTCAGCGAGT -> TGTTTTACTTCATCTCAGCGAGTG
CGCGCCGCCCTTCTAGGAGACAGG -> GCGCCGCCCTTCTAGGAGACAGGG
TTTGATTCACTGTGGGAAGTGCCA -> TTGATTCACTGTGGGAAGTGCCAC
ACCGCAGATCGTCGGGAATTAACA -> CCGCAGATCGTCGGGAATTAACAT
CGATTGCAACATCGGATGTATTGA -> GATTGCAACATCGGATGTATTGAT
AATTATATGGAACACGCATTGCGT -> ATTATATGGAACACGCATTGCGTG
TCATAAGCTCTAGTTAGGGCGGAT -> CATAAGCTCTAGTTAGGGCGGATT
ACAGTCACTAGATAGACAATTTAT -> CAGTCACTAGATAGACAATTTATA
CCCTCTATTTACCAGCCCCCTCAC -> CCTCTATTTACCAGCCCCCTCACG
CCTAGATCTGAACAACAACGAGAC -> CTAGATCTGAACAACAACGAGACC
AAATGGTTTTGATTCACTGTGGGA -> AATGGTTTTGATTCACTGTGGGAA
CGTGGTGCTTCTTACGCTCGGAAG -> GTGGTGCTTCTTACGCTCGGAAGA
TCTAGTTAGGGCGGATTTGGAACT -> CTAGTTAGGGCGGATTTGGAACTC
ACTCGGTTAACTGTTTAATCAGCG -> CTCGGTTAACTGTTTAATCAGCGA
AACAAAATCTAAGTCATACGCCAA -> ACAAAATCTAAGTCATACGCCAAA
AAACCCACTCAATGAGTCTACCTA -> AACCCACTCAATGAGTCTACCTAC
TTTTCTACAAACTGTCGTCTTCTG -> TTTCTACAAACTGTCGTCTTCTGA
GCAGTGCTCCAGGAATGTGCAGAA -> CAGTGCTCCAGGAATGTGCAGAAA
GATAGCTGTCACGGTTGTGATATA -> ATAGCTGTCACGGTTGTGATATAC
GTGCTCAATCGCCTACATTACGTA -> TGCTCAATCGCCTACATTACGTAG
GAGTCATTTGTCTGGAACCGCGCC -> AGTCATTTGTCTGGAACCGCGCCG
TCGTCGGGAATTAACATAGTCTGT -> CGTCGGGAATTAACATAGTCTGTC
CCGCTACTTAGCTTTTTACTGCCG -> CGCTACTTAGCTTTTTACTGCCGG
AGACCTGAATTAGAGATACTCTGG -> GACCTGAATTAGAGATACTCTGGT
ACTTACAGGGTTCCCGCGACGGCG -> CTTACAGGGTTCCCGCGACGGCGC
ATCCCGTAGTGCACATTACGTAAA -> TCCCGTAGTGCACATTACGTAAAC
CCGCGCCGCCCTTCTAGGAGACAG -> CGCGCCGCCCTTCTAGGAGACAGG
CAGCAGACCGAACAGCAGATCTTC -> AGCAGACCGAACAGCAGATCTTCT
AATAGACGCCGTCGTAGGTAGTTC -> ATAGACGCCGTCGTAGGTAGTTCT
TAGGTAGTTCTTTAGCGCCTCGAT -> AGGTAGTTCTTTAGCGCCTCGATT
GAAACATGAACGATTTTTTCTACA -> AAACATGAACGATTTTTTCTACAA
TATAACCTAGCCCGTGGACCCATG -> ATAACCTAGCCCGTGGACCCATGG
GACGCCGTCGTAGGTAGTTCTTTA -> ACGCCGTCGTAGGTAGTTCTTTAG
CTACATTACGTAGGACTACCGCAA -> TACATTACGTAGGACTACCGCAAC
ACTTGAACAGGCAAAGATCGAACC -> CTTGAACAGGCAAAGATCGAACCC
TTTATCATTCTATGCGTAGCTACG -> TTATCATTCTATGCGTAGCTACGG
CCAGCCCCCTCACGCGGAATTCCT -> CAGCCCCCTCACGCGGAATTCCTG
GCTAAGACCCTGAAGAAGACAATT -> CTAAGACCCTGAAGAAGACAATTC
CTCTTGATTTATGACCGACTCGTG -> TCTTGATTTATGACCGACTCGTGT
GTGCAGAAAATACTTCAAGTTCCA -> TGCAGAAAATACTTCAAGTTCCAC
TCACGCGGAATTCCTGCAATATTG -> CACGCGGAATTCCTGCAATATTGG
GCTTTTTACTGCCGGAGGGATCCG -> CTTTTTACTGCCGGAGGGATCCGG
GATCGCGCGTTGTCTCGCATAACT -> ATCGCGCGTTGTCTCGCATAACTC
CTACCGCAACCGACACACACTGAT -> TACCGCAACCGACACACACTGATG
GTGTGTAGTGGTAGAGGAGTTAGA -> TGTGTAGTGGTAGAGGAGTTAGAC
CGTCGGGAATTAACATAGTCTGTC -> GTCGGGAATTAACATAGTCTGTCC
GAACGATTTTTTCTACAAACTGTC -> AACGATTTTTTCTACAAACTGTCG
GCTCTTGATTTATGACCGACTCGT -> CTCTTGATTTATGACCGACTCGTG
CAGCCCCCTCACGCGGAATTCCTG -> AGCCCCCTCACGCGGAATTCCTGC
ACGCCGTCGTAGGTAGTTCTTTAG -> CGCCGTCGTAGGTAGTTCTTTAGC
TCGGTTAACTGTTTAATCAGCGAT -> CGGTTAACTGTTTAATCAGCGATA
AAAGCTCTTGATTTATGACCGACT -> AAGCTCTTGATTTATGACCGACTC
AAGTCAAAGCTCTTGATTTATGAC -> AGTCAAAGCTCTTGATTTATGACC
TTCTACAAACTGTCGTCTTCTGAC -> TCTACAAACTGTCGTCTTCTGACA
TGACGGAGGTATTTTTTTGCTTTC -> GACGGAGGTATTTTTTTGCTTTCC
ACGTTGAGGTCTAACTACTGTGAC -> CGTTGAGGTCTAACTACTGTGACC
TATATTTGAACTGGCACATCGCGA -> ATATTTGAACTGGCACATCGCGAA
TGATTCACTGTGGGAAGTGCCACT -> GATTCACTGTGGGAAGTGCCACTC
CCGGGATTCGGTCCACCTACCAGG -> CGGGATTCGGTCCACCTACCAGGG
CCACTCAAGAGGGGTCTGAACGTT -> CACTCAAGAGGGGTCTGAACGTTG
CTTCTGACAGGTTAGGTCATGGCT -> TTCTGACAGGTTAGGTCATGGCTG
GGAAGAAACTGGTCCGTGGGATAG -> GAAGAAACTGGTCCGTGGGATAGC
AACCCCTGCCGGTGATTGCTAAGA -> ACCCCTGCCGGTGATTGCTAAGAC
ACGGAGGTATTTTTTTGCTTTCCC -> CGGAGGTATTTTTTTGCTTTCCCT
CTGACAGGTTAGGTCATGGCTGGT -> TGACAGGTTAGGTCATGGCTGGTG
CGTCCGTCCAGCAGACCGAACAGC -> GTCCGTCCAGCAGACCGAACAGCA
TCGTCATAAGCTCTAGTTAGGGCG -> CGTCATAAGCTCTAGTTAGGGCGG
ACATTACGTAAACTCGAGTAATCT -> CATTACGTAAACTCGAGTAATCTT
CTTTTTACTGCCGGAGGGATCCGG -> TTTTTACTGCCGGAGGGATCCGGC
GGTATGATTCATGATATAATTCTG -> GTATGATTCATGATATAATTCTGC
AGGACTACCGCAACCGACACACAC -> GGACTACCGCAACCGACACACACT
TGGAGTCATTTGTCTGGAACCGCG -> GGAGTCATTTGTCTGGAACCGCGC
TTGGAGACCTGAATTAGAGATACT -> TGGAGACCTGAATTAGAGATACTC
CTGCCACCAATTATATGGAACACG -> TGCCACCAATTATATGGAACACGC
GTCGAGCGTGGTGCTTCTTACGCT -> TCGAGCGTGGTGCTTCTTACGCTC
AAAGATCGAACCCACGCGATACGA -> AAGATCGAACCCACGCGATACGAC
GTAGAGGAGTTAGACATGCCTCAG -> TAGAGGAGTTAGACATGCCTCAGA
TCCCGTAAATCAGACTGCGACCGG -> CCCGTAAATCAGACTGCGACCGGT
ACAGGGTTCCCGCGACGGCGCAAG -> CAGGGTTCCCGCGACGGCGCAAGC
CCCACGCGATACGACAGATAGACA -> CCACGCGATACGACAGATAGACAG
AAACAAAATCTAAGTCATACGCCA -> AACAAAATCTAAGTCATACGCCAA
TACTTACAGGGTTCCCGCGACGGC -> ACTTACAGGGTTCCCGCGACGGCG
ATATAACCTAGCCCGTGGACCCAT -> TATAACCTAGCCCGTGGACCCATG
TTGTCGTGTAAGGTAGCCACAGAC -> TGTCGTGTAAGGTAGCCACAGACG
GGACAGGGCGGTACTCTATATAAC -> GACAGGGCGGTACTCTATATAACT
AGCGCACCTTCTGCTGCCACCAAT -> GCGCACCTTCTGCTGCCACCAATT
GGTTAGGTAATCGAGCAATGCTAT -> GTTAGGTAATCGAGCAATGCTATT
GGATTTGGAACTCACTCTTGGATG -> GATTTGGAACTCACTCTTGGATGA
GCGTTGTCTCGCATAACTCACTCG -> CGTTGTCTCGCATAACTCACTCGT
GCGGATTTGGAACTCACTCTTGGA -> CGGATTTGGAACTCACTCTTGGAT
GGGGATGAACGTTGTCGTGTAAGG -> GGGATGAACGTTGTCGTGTAAGGT
CGGTGATTGCTAAGACCCTGAAGA -> GGTGATTGCTAAGACCCTGAAGAA
TCAGACTGCGACCGGTTAGGTAAT -> CAGACTGCGACCGGTTAGGTAATC
CTACCGTGTGTCGAGCGTGGTGCT -> TACCGTGTGTCGAGCGTGGTGCTT
GATAGACAATTTATACGACCTCCT -> ATAGACAATTTATACGACCTCCTA
CTTCATCTCAGCGAGTGATTCGCG -> TTCATCTCAGCGAGTGATTCGCGA
TGTCCAGTGCTCCTAGTACTTGAA -> GTCCAGTGCTCCTAGTACTTGAAC
TTATCATTCTATGCGTAGCTACGG -> TATCATTCTATGCGTAGCTACGGG
AAAATACTTCAAGTTCCACAATTA -> AAATACTTCAAGTTCCACAATTAG
TCTGGTAACCTCCATCTACCGTGT -> CTGGTAACCTCCATCTACCGTGTG
CCTGTTGGGATGTAAGGAGGTTAC -> CTGTTGGGATGTAAGGAGGTTACA
TTTTGATTCACTGTGGGAAGTGCC -> TTTGATTCACTGTGGGAAGTGCCA
AGGTTACAACACAGAAATTCAACC -> GGTTACAACACAGAAATTCAACCG
GAACAACAACGAGACCAGGCGATT -> AACAACAACGAGACCAGGCGATTA
TATGCGTAGCTACGGGCGATGCTC -> ATGCGTAGCTACGGGCGATGCTCC
GACCGATTAACCGCAGATCGTCGG -> ACCGATTAACCGCAGATCGTCGGG
ATGGGTCGTATGGAAGGATGCAGA -> TGGGTCGTATGGAAGGATGCAGAC
GAATGTGCAGAAAATACTTCAAGT -> AATGTGCAGAAAATACTTCAAGTT
CCACCAGCGCACCTTCTGCTGCCA -> CACCAGCGCACCTTCTGCTGCCAC
ACTGCGACCGGTTAGGTAATCGAG -> CTGCGACCGGTTAGGTAATCGAGC
GACTGCGACCGGTTAGGTAATCGA -> ACTGCGACCGGTTAGGTAATCGAG
AACATGAACGATTTTTTCTACAAA -> ACATGAACGATTTTTTCTACAAAC
AGCAGATCTTCTCACAAATCCCCT -> GCAGATCTTCTCACAAATCCCCTC
TAGTCGTCCGTCCAGCAGACCGAA -> AGTCGTCCGTCCAGCAGACCGAAC
GGCTGGTGCCGGGGATGAACGTTG -> GCTGGTGCCGGGGATGAACGTTGT
TGCTATTCCCATGTTCGTGGATAT -> GCTATTCCCATGTTCGTGGATATA
AATTTATACGACCTCCTAGATCTG -> ATTTATACGACCTCCTAGATCTGA
CAGGGATTGGGTGGGTGCTCAATC -> AGGGATTGGGTGGGTGCTCAATCG
TGATTCATGATATAATTCTGCCGC -> GATTCATGATATAATTCTGCCGCA
AATCGAGCAATGCTATTCCCATGT -> ATCGAGCAATGCTATTCCCATGTT
TCACTGAAGACTCATGACGGAGGT -> CACTGAAGACTCATGACGGAGGTA
ATTCTATGCGTAGCTACGGGCGAT -> TTCTATGCGTAGCTACGGGCGATG
TAGACATGCCTCAGAAAACTCGGG -> AGACATGCCTCAGAAAACTCGGGG
CGAACCCACGCGATACGACAGATA -> GAACCCACGCGATACGACAGATAG
AAACCTGGCGAAGCAGCGGCATGA -> AACCTGGCGAAGCAGCGGCATGAC
CAATGAGTCTACCTACGAAGCACA -> AATGAGTCTACCTACGAAGCACAA
TTTCCCTCCCGTAAATCAGACTGC -> TTCCCTCCCGTAAATCAGACTGCG
AGGGTCACTCACTGAAGACTCATG -> GGGTCACTCACTGAAGACTCATGA
CTATATAACTTCCTTCATCTTGGT -> TATATAACTTCCTTCATCTTGGTG
ATCGACCGATTAACCGCAGATCGT -> TCGACCGATTAACCGCAGATCGTC
TGTATTGATTTATCATTCTATGCG -> GTATTGATTTATCATTCTATGCGT
GGAGGGATCCGGCTGGGGTTGACC -> GAGGGATCCGGCTGGGGTTGACCA
ACCGGTTAGGTAATCGAGCAATGC -> CCGGTTAGGTAATCGAGCAATGCT
GATCTTCTCACAAATCCCCTCTAT -> ATCTTCTCACAAATCCCCTCTATT
CAGCCGCTACTTAGCTTTTTACTG -> AGCCGCTACTTAGCTTTTTACTGC
AACGGTGGAGTCATTTGTCTGGAA -> ACGGTGGAGTCATTTGTCTGGAAC
TTCAAGTTCCACAATTAGTCGTCC -> TCAAGTTCCACAATTAGTCGTCCG
TAGAGATACTCTGGTAACCTCCAT -> AGAGATACTCTGGTAACCTCCATC
GCCTACATTGCCGGGGTGTGTCCA -> CCTACATTGCCGGGGTGTGTCCAG
CTGGAACCGCGCCGCCCTTCTAGG -> TGGAACCGCGCCGCCCTTCTAGGA
GTGTAGTGGTAGAGGAGTTAGACA -> TGTAGTGGTAGAGGAGTTAGACAT
TAACAAACTCGGTTAACTGTTTAA -> AACAAACTCGGTTAACTGTTTAAT
TGCAGACACGTTCCCTCGAAACCC -> GCAGACACGTTCCCTCGAAACCCA
GAGCAATGCTATTCCCATGTTCGT -> AGCAATGCTATTCCCATGTTCGTG
AATTAACATAGTCTGTCCGGGATT -> ATTAACATAGTCTGTCCGGGATTC
TTAGTCGTCCGTCCAGCAGACCGA -> TAGTCGTCCGTCCAGCAGACCGAA
GAACTCACTCTTGGATGAATCCCA -> AACTCACTCTTGGATGAATCCCAC
TTACTGCCGGAGGGATCCGGCTGG -> TACTGCCGGAGGGATCCGGCTGGG
TGGAGACCTGAATTAGAGATACTC -> GGAGACCTGAATTAGAGATACTCT
GTGATATACCTTTTTTGAAACAAA -> TGATATACCTTTTTTGAAACAAAA
CGGCGCAAGCGTCGTGGAGAAACA -> GGCGCAAGCGTCGTGGAGAAACAT
TCATGCGGGCATACTGACACGAAG -> CATGCGGGCATACTGACACGAAGT
AAAACCTGGCGAAGCAGCGGCATG -> AAACCTGGCGAAGCAGCGGCATGA
ATACTGACACGAAGTCAAAGCTCT -> TACTGACACGAAGTCAAAGCTCTT
GTCCACCTACCAGGGTCACTCACT -> TCCACCTACCAGGGTCACTCACTG
GGTTAGGTCATGGCTGGTGCCGGG -> GTTAGGTCATGGCTGGTGCCGGGG
ATGGCTCAGTTGTTTTACTTCATC -> TGGCTCAGTTGTTTTACTTCATCT
TCGTGGAGAAACATGAACGATTTT -> CGTGGAGAAACATGAACGATTTTT
TAGCCCGTGGACCCATGGGCGTCG -> AGCCCGTGGACCCATGGGCGTCGG
TTTTTCTACAAACTGTCGTCTTCT -> TTTTCTACAAACTGTCGTCTTCTG
GGTCTGAACGTTGAGGTCTAACTA -> GTCTGAACGTTGAGGTCTAACTAC
AGAGATACTCTGGTAACCTCCATC -> GAGATACTCTGGTAACCTCCATCT
GCAAATGCTAGTACTTACAGGGTT -> CAAATGCTAGTACTTACAGGGTTC
TCCGGGATTCGGTCCACCTACCAG -> CCGGGATTCGGTCCACCTACCAGG
GGGATTCGGTCCACCTACCAGGGT -> GGATTCGGTCCACCTACCAGGGTC
AAGAGGGGTCTGAACGTTGAGGTC -> AGAGGGGTCTGAACGTTGAGGTCT
TTTTTATCGACCAATTGTGACCAT -> TTTTATCGACCAATTGTGACCATG
ATTATCTCGGATATTCGGAGAAGT -> TTATCTCGGATATTCGGAGAAGTA
ACCTAGCCCGTGGACCCATGGGCG -> CCTAGCCCGTGGACCCATGGGCGT
CGCGATCGCGCGTTGTCTCGCATA -> GCGATCGCGCGTTGTCTCGCATAA
GGGTTGACCACAACCCCTGCCGGT -> GGTTGACCACAACCCCTGCCGGTG
CCGAACAGCAGATCTTCTCACAAA -> CGAACAGCAGATCTTCTCACAAAT
GAAGTGCCACTCAAGAGGGGTCTG -> AAGTGCCACTCAAGAGGGGTCTGA
ATCGAGCAATGCTATTCCCATGTT -> TCGAGCAATGCTATTCCCATGTTC
GCGCCTCGATTGCAACATCGGATG -> CGCCTCGATTGCAACATCGGATGT
ATTTTTTCTACAAACTGTCGTCTT -> TTTTTTCTACAAACTGTCGTCTTC
TTTTTGCTTTCCCTCCCGTAAATC -> TTTTGCTTTCCCTCCCGTAAATCA
TGGAGGCCCACTGTCATGCGGGCA -> GGAGGCCCACTGTCATGCGGGCAT
AGTGCTCCTAGTACTTGAACAGGC -> GTGCTCCTAGTACTTGAACAGGCA
GCAGATCGTCGGGAATTAACATAG -> CAGATCGTCGGGAATTAACATAGT
GCATGACTATAGGATCGTCGGTAG -> CATGACTATAGGATCGTCGGTAGC
GGTGCTCAATCGCCTACATTACGT -> GTGCTCAATCGCCTACATTACGTA
TTGGTGATCCCGTAGTGCACATTA -> TGGTGATCCCGTAGTGCACATTAC
CGGGGTGTGTCCAGTGCTCCTAGT -> GGGGTGTGTCCAGTGCTCCTAGTA
CCCACCACAGGCGCTCGATACGCC -> CCACCACAGGCGCTCGATACGCCC
CGTCGTGGAGAAACATGAACGATT -> GTCGTGGAGAAACATGAACGATTT
TACTTGAACAGGCAAAGATCGAAC -> ACTTGAACAGGCAAAGATCGAACC
CTGTGACCATTATCTCGGATATTC -> TGTGACCATTATCTCGGATATTCG
CACTGTGGGAAGTGCCACTCAAGA -> ACTGTGGGAAGTGCCACTCAAGAG
TGACCGACTCGTGTTAAGAAAAAC -> GACCGACTCGTGTTAAGAAAAACC
AGGATCGTCGGTAGCTGGTATGAT -> GGATCGTCGGTAGCTGGTATGATT
GCTGTCACGGTTGTGATATACCTT -> CTGTCACGGTTGTGATATACCTTT
GGCGCTCGATACGCCCGGGTAGGG -> GCGCTCGATACGCCCGGGTAGGGC
AACGAGACCAGGCGATTAACAAAC -> ACGAGACCAGGCGATTAACAAACT
CAATTCTCGCAGTGCTCCAGGAAT -> AATTCTCGCAGTGCTCCAGGAATG
GGTAGCTGGTATGATTCATGATAT -> GTAGCTGGTATGATTCATGATATA
CGCCAAATCGATCGTCATAAGCTC -> GCCAAATCGATCGTCATAAGCTCT
GTAATAGACGCCGTCGTAGGTAGT -> TAATAGACGCCGTCGTAGGTAGTT
TCATGATATAATTCTGCCGCAGAA -> CATGATATAATTCTGCCGCAGAAA
AGGATTTTTTATCGACCAATTGTG -> GGATTTTTTATCGACCAATTGTGA
AACGTTGAGGTCTAACTACTGTGA -> ACGTTGAGGTCTAACTACTGTGAC
AATCCCACCAGCGCACCTTCTGCT -> ATCCCACCAGCGCACCTTCTGCTG
ACATTTGGATCGACCGATTAACCG -> CATTTGGATCGACCGATTAACCGC
TCCCTCGAAACCCACTCAATGAGT -> CCCTCGAAACCCACTCAATGAGTC
CACCAGCGCACCTTCTGCTGCCAC -> ACCAGCGCACCTTCTGCTGCCACC
TGCCTCAGAAAACTCGGGGCCTCA -> GCCTCAGAAAACTCGGGGCCTCAT
CATGACGGAGGTATTTTTTTGCTT -> ATGACGGAGGTATTTTTTTGCTTT
CATGGCTCAGTTGTTTTACTTCAT -> ATGGCTCAGTTGTTTTACTTCATC
TAATAGACGCCGTCGTAGGTAGTT -> AATAGACGCCGTCGTAGGTAGTTC
ATGAAAACAGACGGCCTGTTGGGA -> TGAAAACAGACGGCCTGTTGGGAT
TCTATTTACCAGCCCCCTCACGCG -> CTATTTACCAGCCCCCTCACGCGG
GGTACTCTATATAACTTCCTTCAT -> GTACTCTATATAACTTCCTTCATC
AGCCACAGACGCCTATATTTGAAC -> GCCACAGACGCCTATATTTGAACT
AACTGTCGTCTTCTGACAGGTTAG -> ACTGTCGTCTTCTGACAGGTTAGG
TTGACCACAACCCCTGCCGGTGAT -> TGACCACAACCCCTGCCGGTGATT
CACCAATTATATGGAACACGCATT -> ACCAATTATATGGAACACGCATTG
GGAGAAGTAGTCCTCTCACAGGTC -> GAGAAGTAGTCCTCTCACAGGTCC
CGTGTTAAGAAAAACCTGGCGAAG -> GTGTTAAGAAAAACCTGGCGAAGC
TTGGAACTCACTCTTGGATGAATC -> TGGAACTCACTCTTGGATGAATCC
CTAAGTCATACGCCAAATCGATCG -> TAAGTCATACGCCAAATCGATCGT
TATTTGAACTGGCACATCGCGAAG -> ATTTGAACTGGCACATCGCGAAGG
GAATCCCACCAGCGCACCTTCTGC -> AATCCCACCAGCGCACCTTCTGCT
ACATGCCTCAGAAAACTCGGGGCC -> CATGCCTCAGAAAACTCGGGGCCT
ATGGAAGGATGCAGACACGTTCCC -> TGGAAGGATGCAGACACGTTCCCT
GCAGAAAATACTTCAAGTTCCACA -> CAGAAAATACTTCAAGTTCCACAA
CCGGGGATGAACGTTGTCGTGTAA -> CGGGGATGAACGTTGTCGTGTAAG
TGGTCCGTGGGATAGCTGTCACGG -> GGTCCGTGGGATAGCTGTCACGGT
GGCGAAGCAGCGGCATGACTATAG -> GCGAAGCAGCGGCATGACTATAGG
TACTGTGACCATTATCTCGGATAT -> ACTGTGACCATTATCTCGGATATT
GATTCACTGTGGGAAGTGCCACTC -> ATTCACTGTGGGAAGTGCCACTCA
GCTCCGGCCTACATTGCCGGGGTG -> CTCCGGCCTACATTGCCGGGGTGT
AGTGGTAGAGGAGTTAGACATGCC -> GTGGTAGAGGAGTTAGACATGCCT
ATGCTATTCCCATGTTCGTGGATA -> TGCTATTCCCATGTTCGTGGATAT
TTACGTAGGACTACCGCAACCGAC -> TACGTAGGACTACCGCAACCGACA
GTAGCTGGTATGATTCATGATATA -> TAGCTGGTATGATTCATGATATAA
TTTAGCGCCTCGATTGCAACATCG -> TTAGCGCCTCGATTGCAACATCGG
GACAGGTTAGGTCATGGCTGGTGC -> ACAGGTTAGGTCATGGCTGGTGCC
TAAACTCGAGTAATCTTGGTACAA -> AAACTCGAGTAATCTTGGTACAAC
GCTACAAATGGTTTTGATTCACTG -> CTACAAATGGTTTTGATTCACTGT
GAAAACAGACGGCCTGTTGGGATG -> AAAACAGACGGCCTGTTGGGATGT
AACCTAGCCCGTGGACCCATGGGC -> ACCTAGCCCGTGGACCCATGGGCG
ACAAGATTGGTGCAGCCATGGCTC -> CAAGATTGGTGCAGCCATGGCTCA
GAGGTCTAACTACTGTGACCATTA -> AGGTCTAACTACTGTGACCATTAT
GACCGGTTAGGTAATCGAGCAATG -> ACCGGTTAGGTAATCGAGCAATGC
CTCGAAACCCACTCAATGAGTCTA -> TCGAAACCCACTCAATGAGTCTAC
GGGTAGGGCTACAAATGGTTTTGA -> GGTAGGGCTACAAATGGTTTTGAT
CGTCCAGCAGACCGAACAGCAGAT -> GTCCAGCAGACCGAACAGCAGATC
TCGGTCCACCTACCAGGGTCACTC -> CGGTCCACCTACCAGGGTCACTCA
TCCTAGATCTGAACAACAACGAGA -> CCTAGATCTGAACAACAACGAGAC
GCCCGTGGACCCATGGGCGTCGGA -> CCCGTGGACCCATGGGCGTCGGAT
TTTGTCTGGAACCGCGCCGCCCTT -> TTGTCTGGAACCGCGCCGCCCTTC
ATTCTCGCAGTGCTCCAGGAATGT -> TTCTCGCAGTGCTCCAGGAATGTG
ATCGGATGTATTGATTTATCATTC -> TCGGATGTATTGATTTATCATTCT
TTTATGACCGACTCGTGTTAAGAA -> TTATGACCGACTCGTGTTAAGAAA
TCAAGTTCCACAATTAGTCGTCCG -> CAAGTTCCACAATTAGTCGTCCGT
TACGATGAAAACAGACGGCCTGTT -> ACGATGAAAACAGACGGCCTGTTG
TTCTTTAGCGCCTCGATTGCAACA -> TCTTTAGCGCCTCGATTGCAACAT
TCTCAGCGAGTGATTCGCGATCGC -> CTCAGCGAGTGATTCGCGATCGCG
GGGGTTGACCACAACCCCTGCCGG -> GGGTTGACCACAACCCCTGCCGGT
TTAGCTTTTTACTGCCGGAGGGAT -> TAGCTTTTTACTGCCGGAGGGATC
GGATATAACCTAGCCCGTGGACCC -> GATATAACCTAGCCCGTGGACCCA
CAGCCATGGCTCAGTTGTTTTACT -> AGCCATGGCTCAGTTGTTTTACTT
GAAGACTCATGACGGAGGTATTTT -> AAGACTCATGACGGAGGTATTTTT
AGAAACTGGTCCGTGGGATAGCTG -> GAAACTGGTCCGTGGGATAGCTGT
GATGCTCCGGCCTACATTGCCGGG -> ATGCTCCGGCCTACATTGCCGGGG
TCGAACCCACGCGATACGACAGAT -> CGAACCCACGCGATACGACAGATA
TACCAGGGTCACTCACTGAAGACT -> ACCAGGGTCACTCACTGAAGACTC
TGTCCGGGATTCGGTCCACCTACC -> GTCCGGGATTCGGTCCACCTACCA
CTCATGACGGAGGTATTTTTTTGC -> TCATGACGGAGGTATTTTTTTGCT
AAGCTCTAGTTAGGGCGGATTTGG -> AGCTCTAGTTAGGGCGGATTTGGA
AATCTTGGTACAACGATCCGGGAT -> ATCTTGGTACAACGATCCGGGATG
ATCTCGGATATTCGGAGAAGTAGT -> TCTCGGATATTCGGAGAAGTAGTC
CAGCGGCATGACTATAGGATCGTC -> AGCGGCATGACTATAGGATCGTCG
CAGACGCCTATATTTGAACTGGCA -> AGACGCCTATATTTGAACTGGCAC
TCGGAGAAGTAGTCCTCTCACAGG -> CGGAGAAGTAGTCCTCTCACAGGT
ACCTCCTAGATCTGAACAACAACG -> CCTCCTAGATCTGAACAACAACGA
CCGCCGAGTGTGTAGTGGTAGAGG -> CGCCGAGTGTGTAGTGGTAGAGGA
GTTGAGGTCTAACTACTGTGACCA -> TTGAGGTCTAACTACTGTGACCAT
ATGGCTGGTGCCGGGGATGAACGT -> TGGCTGGTGCCGGGGATGAACGTT
AATCCCCTCTATTTACCAGCCCCC -> ATCCCCTCTATTTACCAGCCCCCT
GGTGCTTCTTACGCTCGGAAGAAA -> GTGCTTCTTACGCTCGGAAGAAAC
CGCTACTTAGCTTTTTACTGCCGG -> GCTACTTAGCTTTTTACTGCCGGA
GTCATAAGCTCTAGTTAGGGCGGA -> TCATAAGCTCTAGTTAGGGCGGAT
CCGTAGTGCACATTACGTAAACTC -> CGTAGTGCACATTACGTAAACTCG
TTAGCGCCTCGATTGCAACATCGG -> TAGCGCCTCGATTGCAACATCGGA
CCGGCCTACATTGCCGGGGTGTGT -> CGGCCTACATTGCCGGGGTGTGTC
TAGGGCTACAAATGGTTTTGATTC -> AGGGCTACAAATGGTTTTGATTCA
CATCGGATGTATTGATTTATCATT -> ATCGGATGTATTGATTTATCATTC
GAAACTGGTCCGTGGGATAGCTGT -> AAACTGGTCCGTGGGATAGCTGTC
GATCCGGCTGGGGTTGACCACAAC -> ATCCGGCTGGGGTTGACCACAACC
TTGGATGAATCCCACCAGCGCACC -> TGGATGAATCCCACCAGCGCACCT
CGGGCCTTTATCCCACCACAGGCG -> GGGCCTTTATCCCACCACAGGCGC
AACTCACTCGTTACGATGAAAACA -> ACTCACTCGTTACGATGAAAACAG
ACTCAATGAGTCTACCTACGAAGC -> CTCAATGAGTCTACCTACGAAGCA
GTGTGTCGAGCGTGGTGCTTCTTA -> TGTGTCGAGCGTGGTGCTTCTTAC
ACAGACGCCTATATTTGAACTGGC -> CAGACGCCTATATTTGAACTGGCA
ACGTAGGACTACCGCAACCGACAC -> CGTAGGACTACCGCAACCGACACA
ACCTACGAAGCACAAGATTGGTGC -> CCTACGAAGCACAAGATTGGTGCA
ATGTAAGGAGGTTACAACACAGAA -> TGTAAGGAGGTTACAACACAGAAA
TGACCATGTGAACATGAACGGTGG -> GACCATGTGAACATGAACGGTGGA
ATTCCTGCAATATTGGAGACCTGA -> TTCCTGCAATATTGGAGACCTGAA
CCGCCCTTCTAGGAGACAGGGATT -> CGCCCTTCTAGGAGACAGGGATTG
AGTGATTCGCGATCGCGCGTTGTC -> GTGATTCGCGATCGCGCGTTGTCT
TGAACGATTTTTTCTACAAACTGT -> GAACGATTTTTTCTACAAACTGTC
CTGTCATGCGGGCATACTGACACG -> TGTCATGCGGGCATACTGACACGA
CCTACGAAGCACAAGATTGGTGCA -> CTACGAAGCACAAGATTGGTGCAG
AGATCGTCGGGAATTAACATAGTC -> GATCGTCGGGAATTAACATAGTCT
TGCAACATCGGATGTATTGATTTA -> GCAACATCGGATGTATTGATTTAT
CGAAGGATTTTTTATCGACCAATT -> GAAGGATTTTTTATCGACCAATTG
GTCGTATGGAAGGATGCAGACACG -> TCGTATGGAAGGATGCAGACACGT
AAGTAGTCCTCTCACAGGTCCACA -> AGTAGTCCTCTCACAGGTCCACAC
GACTACCGCAACCGACACACACTG -> ACTACCGCAACCGACACACACTGA
AATGCTAGTACTTACAGGGTTCCC -> ATGCTAGTACTTACAGGGTTCCCG
TATCTCGGATATTCGGAGAAGTAG -> ATCTCGGATATTCGGAGAAGTAGT
CTGACACGAAGTCAAAGCTCTTGA -> TGACACGAAGTCAAAGCTCTTGAT
GCACATTACGTAAACTCGAGTAAT -> CACATTACGTAAACTCGAGTAATC
TCCATCTACCGTGTGTCGAGCGTG -> CCATCTACCGTGTGTCGAGCGTGG
GGTAATCGAGCAATGCTATTCCCA -> GTAATCGAGCAATGCTATTCCCAT
CATTGCGTGCAAATGCTAGTACTT -> ATTGCGTGCAAATGCTAGTACTTA
TAGATCTGAACAACAACGAGACCA -> AGATCTGAACAACAACGAGACCAG
GTAATCGAGCAATGCTATTCCCAT -> TAATCGAGCAATGCTATTCCCATG
CGCAGATCGTCGGGAATTAACATA -> GCAGATCGTCGGGAATTAACATAG
GCGAAGGATTTTTTATCGACCAAT -> CGAAGGATTTTTTATCGACCAATT
TGTGAACATGAACGGTGGAGTCAT -> GTGAACATGAACGGTGGAGTCATT
ATCCGGGATGAATGATTATGGGTC -> TCCGGGATGAATGATTATGGGTCG
GATGTATTGATTTATCATTCTATG -> ATGTATTGATTTATCATTCTATGC
TTCACTGTGGGAAGTGCCACTCAA -> TCACTGTGGGAAGTGCCACTCAAG
CATTATCTCGGATATTCGGAGAAG -> ATTATCTCGGATATTCGGAGAAGT
GTGCCGGGGATGAACGTTGTCGTG -> TGCCGGGGATGAACGTTGTCGTGT
CCAATTATATGGAACACGCATTGC -> CAATTATATGGAACACGCATTGCG
CAGACACGTTCCCTCGAAACCCAC -> AGACACGTTCCCTCGAAACCCACT
CCGTGGACCCATGGGCGTCGGATA -> CGTGGACCCATGGGCGTCGGATAA
TTAATCAGCGATACGGACAGGGCG -> TAATCAGCGATACGGACAGGGCGG
CCTCACGCGGAATTCCTGCAATAT -> CTCACGCGGAATTCCTGCAATATT
ACACAGAAATTCAACCGCCGAGTG -> CACAGAAATTCAACCGCCGAGTGT
TTCATGATATAATTCTGCCGCAGA -> TCATGATATAATTCTGCCGCAGAA
AAGGATGCAGACACGTTCCCTCGA -> AGGATGCAGACACGTTCCCTCGAA
TTTTTTTGCTTTCCCTCCCGTAAA -> TTTTTTGCTTTCCCTCCCGTAAAT
GGTCCACCTACCAGGGTCACTCAC -> GTCCACCTACCAGGGTCACTCACT
ATTTGGATCGACCGATTAACCGCA -> TTTGGATCGACCGATTAACCGCAG
TTAGGTAATCGAGCAATGCTATTC -> TAGGTAATCGAGCAATGCTATTCC
CCCTCACGCGGAATTCCTGCAATA -> CCTCACGCGGAATTCCTGCAATAT
GTCTACCTACGAAGCACAAGATTG -> TCTACCTACGAAGCACAAGATTGG
GATTCGGTCCACCTACCAGGGTCA -> ATTCGGTCCACCTACCAGGGTCAC
ACCCCTGCCGGTGATTGCTAAGAC -> CCCCTGCCGGTGATTGCTAAGACC
TGCTCCAGGAATGTGCAGAAAATA -> GCTCCAGGAATGTGCAGAAAATAC
AAAATCTAAGTCATACGCCAAATC -> AAATCTAAGTCATACGCCAAATCG
ACTGTCATGCGGGCATACTGACAC -> CTGTCATGCGGGCATACTGACACG
ACGATCCGGGATGAATGATTATGG -> CGATCCGGGATGAATGATTATGGG
TCTTTAGCGCCTCGATTGCAACAT -> CTTTAGCGCCTCGATTGCAACATC
GCTGTCAGCCGCTACTTAGCTTTT -> CTGTCAGCCGCTACTTAGCTTTTT
GCAACATCGGATGTATTGATTTAT -> CAACATCGGATGTATTGATTTATC
GTCCAGCAGACCGAACAGCAGATC -> TCCAGCAGACCGAACAGCAGATCT
AGGAATGTGCAGAAAATACTTCAA -> GGAATGTGCAGAAAATACTTCAAG
CATTACGTAAACTCGAGTAATCTT -> ATTACGTAAACTCGAGTAATCTTG
GCCGGGGATGAACGTTGTCGTGTA -> CCGGGGATGAACGTTGTCGTGTAA
TGCCGGGGTGTGTCCAGTGCTCCT -> GCCGGGGTGTGTCCAGTGCTCCTA
GGATTGGGTGGGTGCTCAATCGCC -> GATTGGGTGGGTGCTCAATCGCCT
GATGAATCCCACCAGCGCACCTTC -> ATGAATCCCACCAGCGCACCTTCT
CATCGCGAAGGATTTTTTATCGAC -> ATCGCGAAGGATTTTTTATCGACC
AGCCCCCTCACGCGGAATTCCTGC -> GCCCCCTCACGCGGAATTCCTGCA
TACTCTATATAACTTCCTTCATCT -> ACTCTATATAACTTCCTTCATCTT
TCGGATAAACGGCTGTCAGCCGCT -> CGGATAAACGGCTGTCAGCCGCTA
CATGTTCGTGGATATAACCTAGCC -> ATGTTCGTGGATATAACCTAGCCC
GAGGCCCACTGTCATGCGGGCATA -> AGGCCCACTGTCATGCGGGCATAC
CGCAAGCGTCGTGGAGAAACATGA -> GCAAGCGTCGTGGAGAAACATGAA
AACAGGCAAAGATCGAACCCACGC -> ACAGGCAAAGATCGAACCCACGCG
GGCGATTAACAAACTCGGTTAACT -> GCGATTAACAAACTCGGTTAACTG
AACTCGAGTAATCTTGGTACAACG -> ACTCGAGTAATCTTGGTACAACGA
AGAAAATACTTCAAGTTCCACAAT -> GAAAATACTTCAAGTTCCACAATT
AGCGGGCCTTTATCCCACCACAGG -> GCGGGCCTTTATCCCACCACAGGC
AGGTATTTTTTTGCTTTCCCTCCC -> GGTATTTTTTTGCTTTCCCTCCCG
ATAAACGGCTGTCAGCCGCTACTT -> TAAACGGCTGTCAGCCGCTACTTA
AAACTGTCGTCTTCTGACAGGTTA -> AACTGTCGTCTTCTGACAGGTTAG
GTTCTTTAGCGCCTCGATTGCAAC -> TTCTTTAGCGCCTCGATTGCAACA
GGGCGGTACTCTATATAACTTCCT -> GGCGGTACTCTATATAACTTCCTT
CGGACAGGGCGGTACTCTATATAA -> GGACAGGGCGGTACTCTATATAAC
TCAAAGCTCTTGATTTATGACCGA -> CAAAGCTCTTGATTTATGACCGAC
CCTAGTACTTGAACAGGCAAAGAT -> CTAGTACTTGAACAGGCAAAGATC
CTATGCGTAGCTACGGGCGATGCT -> TATGCGTAGCTACGGGCGATGCTC
TCAGCGAGTGATTCGCGATCGCGC -> CAGCGAGTGATTCGCGATCGCGCG
TGTCGTGTAAGGTAGCCACAGACG -> GTCGTGTAAGGTAGCCACAGACGC
AGGCGATTAACAAACTCGGTTAAC -> GGCGATTAACAAACTCGGTTAACT
CGAAACCCACTCAATGAGTCTACC -> GAAACCCACTCAATGAGTCTACCT
GGAATTCCTGCAATATTGGAGACC -> GAATTCCTGCAATATTGGAGACCT
TTCTATGCGTAGCTACGGGCGATG -> TCTATGCGTAGCTACGGGCGATGC
TTTACTGCCGGAGGGATCCGGCTG -> TTACTGCCGGAGGGATCCGGCTGG
AGCCCGTGGACCCATGGGCGTCGG -> GCCCGTGGACCCATGGGCGTCGGA
TACTCTGGTAACCTCCATCTACCG -> ACTCTGGTAACCTCCATCTACCGT
TATCCCACCACAGGCGCTCGATAC -> ATCCCACCACAGGCGCTCGATACG
TTTATCGACCAATTGTGACCATGT -> TTATCGACCAATTGTGACCATGTG
TACAAACTGTCGTCTTCTGACAGG -> ACAAACTGTCGTCTTCTGACAGGT
AGACCGAACAGCAGATCTTCTCAC -> GACCGAACAGCAGATCTTCTCACA
CACACATTTGGATCGACCGATTAA -> ACACATTTGGATCGACCGATTAAC
ACAGGTTAGGTCATGGCTGGTGCC -> CAGGTTAGGTCATGGCTGGTGCCG
GGAGACAGGGATTGGGTGGGTGCT -> GAGACAGGGATTGGGTGGGTGCTC
AGGTCATGGCTGGTGCCGGGGATG -> GGTCATGGCTGGTGCCGGGGATGA
CCCCTCTATTTACCAGCCCCCTCA -> CCCTCTATTTACCAGCCCCCTCAC
GACCACAACCCCTGCCGGTGATTG -> ACCACAACCCCTGCCGGTGATTGC
GTATTGATTTATCATTCTATGCGT -> TATTGATTTATCATTCTATGCGTA
GAGGTATTTTTTTGCTTTCCCTCC -> AGGTATTTTTTTGCTTTCCCTCCC
CCATGTGAACATGAACGGTGGAGT -> CATGTGAACATGAACGGTGGAGTC
GTGGGTGCTCAATCGCCTACATTA -> TGGGTGCTCAATCGCCTACATTAC
GCCATGGCTCAGTTGTTTTACTTC -> CCATGGCTCAGTTGTTTTACTTCA
GATACTCTGGTAACCTCCATCTAC -> ATACTCTGGTAACCTCCATCTACC
TATCGACCAATTGTGACCATGTGA -> ATCGACCAATTGTGACCATGTGAA
TATTCCCATGTTCGTGGATATAAC -> ATTCCCATGTTCGTGGATATAACC
CACTGATGCGTGGAGGCCCACTGT -> ACTGATGCGTGGAGGCCCACTGTC
GCTCGATACGCCCGGGTAGGGCTA -> CTCGATACGCCCGGGTAGGGCTAC
CTACTGTGACCATTATCTCGGATA -> TACTGTGACCATTATCTCGGATAT
ATGTATTGATTTATCATTCTATGC -> TGTATTGATTTATCATTCTATGCG
ATCGCGAAGGATTTTTTATCGACC -> TCGCGAAGGATTTTTTATCGACCA
CAGAAAATACTTCAAGTTCCACAA -> AGAAAATACTTCAAGTTCCACAAT
TTAACATAGTCTGTCCGGGATTCG -> TAACATAGTCTGTCCGGGATTCGG
TGAACGTTGTCGTGTAAGGTAGCC -> GAACGTTGTCGTGTAAGGTAGCCA
GTGATTGCTAAGACCCTGAAGAAG -> TGATTGCTAAGACCCTGAAGAAGA
GACCGACTCGTGTTAAGAAAAACC -> ACCGACTCGTGTTAAGAAAAACCT
ATATGGAACACGCATTGCGTGCAA -> TATGGAACACGCATTGCGTGCAAA
CTCGCAGTGCTCCAGGAATGTGCA -> TCGCAGTGCTCCAGGAATGTGCAG
ACAACCCCTGCCGGTGATTGCTAA -> CAACCCCTGCCGGTGATTGCTAAG
GCTCTAGTTAGGGCGGATTTGGAA -> CTCTAGTTAGGGCGGATTTGGAAC
CGTATGGAAGGATGCAGACACGTT -> GTATGGAAGGATGCAGACACGTTC
GTCTGAACGTTGAGGTCTAACTAC -> TCTGAACGTTGAGGTCTAACTACT
CGCACCTTCTGCTGCCACCAATTA -> GCACCTTCTGCTGCCACCAATTAT
CGCCGCCCTTCTAGGAGACAGGGA -> GCCGCCCTTCTAGGAGACAGGGAT
AAGAAGACAATTCTCGCAGTGCTC -> AGAAGACAATTCTCGCAGTGCTCC
TGAATGATTATGGGTCGTATGGAA -> GAATGATTATGGGTCGTATGGAAG
CAACCCCTGCCGGTGATTGCTAAG -> AACCCCTGCCGGTGATTGCTAAGA
AGCCATGGCTCAGTTGTTTTACTT -> GCCATGGCTCAGTTGTTTTACTTC
TCTGAACAACAACGAGACCAGGCG -> CTGAACAACAACGAGACCAGGCGA
ATAACTCACTCGTTACGATGAAAA -> TAACTCACTCGTTACGATGAAAAC
TCTGTCCGGGATTCGGTCCACCTA -> CTGTCCGGGATTCGGTCCACCTAC
CAGACGGCCTGTTGGGATGTAAGG -> AGACGGCCTGTTGGGATGTAAGGA
GGGATTGGGTGGGTGCTCAATCGC -> GGATTGGGTGGGTGCTCAATCGCC
ACCAGGGTCACTCACTGAAGACTC -> CCAGGGTCACTCACTGAAGACTCA
CGTGCAAATGCTAGTACTTACAGG -> GTGCAAATGCTAGTACTTACAGGG
GGTGGAGTCATTTGTCTGGAACCG -> GTGGAGTCATTTGTCTGGAACCGC
AGTCATTTGTCTGGAACCGCGCCG -> GTCATTTGTCTGGAACCGCGCCGC
AATTCCTGCAATATTGGAGACCTG -> ATTCCTGCAATATTGGAGACCTGA
TTCGGAGAAGTAGTCCTCTCACAG -> TCGGAGAAGTAGTCCTCTCACAGG
GACACGAAGTCAAAGCTCTTGATT -> ACACGAAGTCAAAGCTCTTGATTT
TTCGTGGATATAACCTAGCCCGTG -> TCGTGGATATAACCTAGCCCGTGG
TCTATATAACTTCCTTCATCTTGG -> CTATATAACTTCCTTCATCTTGGT
ACCGAACAGCAGATCTTCTCACAA -> CCGAACAGCAGATCTTCTCACAAA
CGTGGAGAAACATGAACGATTTTT -> GTGGAGAAACATGAACGATTTTTT
ATCGAACCCACGCGATACGACAGA -> TCGAACCCACGCGATACGACAGAT
GATCGTCGGTAGCTGGTATGATTC -> ATCGTCGGTAGCTGGTATGATTCA
TGAAGACTCATGACGGAGGTATTT -> GAAGACTCATGACGGAGGTATTTT
GCACATCGCGAAGGATTTTTTATC -> CACATCGCGAAGGATTTTTTATCG
CTGTCGTCTTCTGACAGGTTAGGT -> TGTCGTCTTCTGACAGGTTAGGTC
CACTCAAGAGGGGTCTGAACGTTG -> ACTCAAGAGGGGTCTGAACGTTGA
TAGGACTACCGCAACCGACACACA -> AGGACTACCGCAACCGACACACAC
CATGCGGGCATACTGACACGAAGT -> ATGCGGGCATACTGACACGAAGTC
CAAATCGATCGTCATAAGCTCTAG -> AAATCGATCGTCATAAGCTCTAGT
GATACGGACAGGGCGGTACTCTAT -> ATACGGACAGGGCGGTACTCTATA
CTGCGACCGGTTAGGTAATCGAGC -> TGCGACCGGTTAGGTAATCGAGCA
GAGTAATCTTGGTACAACGATCCG -> AGTAATCTTGGTACAACGATCCGG
GGGTGGGTGCTCAATCGCCTACAT -> GGTGGGTGCTCAATCGCCTACATT
CTGCTGCCACCAATTATATGGAAC -> TGCTGCCACCAATTATATGGAACA
CCGGTGATTGCTAAGACCCTGAAG -> CGGTGATTGCTAAGACCCTGAAGA
ATGCTAGTACTTACAGGGTTCCCG -> TGCTAGTACTTACAGGGTTCCCGC
GTGAACATGAACGGTGGAGTCATT -> TGAACATGAACGGTGGAGTCATTT
GGTAACCTCCATCTACCGTGTGTC -> GTAACCTCCATCTACCGTGTGTCG
AAGACCCTGAAGAAGACAATTCTC -> AGACCCTGAAGAAGACAATTCTCG
TGTGACCATTATCTCGGATATTCG -> GTGACCATTATCTCGGATATTCGG
TTTACTTCATCTCAGCGAGTGATT -> TTACTTCATCTCAGCGAGTGATTC
ACAATTAGTCGTCCGTCCAGCAGA -> CAATTAGTCGTCCGTCCAGCAGAC
ACCATTATCTCGGATATTCGGAGA -> CCATTATCTCGGATATTCGGAGAA
TTAACCGCAGATCGTCGGGAATTA -> TAACCGCAGATCGTCGGGAATTAA
CCAAATCGATCGTCATAAGCTCTA -> CAAATCGATCGTCATAAGCTCTAG
ACGGACAGGGCGGTACTCTATATA -> CGGACAGGGCGGTACTCTATATAA
TGATTCGCGATCGCGCGTTGTCTC -> GATTCGCGATCGCGCGTTGTCTCG
TGTCAGCCGCTACTTAGCTTTTTA -> GTCAGCCGCTACTTAGCTTTTTAC
GATAGACAGTCACTAGATAGACAA -> ATAGACAGTCACTAGATAGACAAT
TGAACTGGCACATCGCGAAGGATT -> GAACTGGCACATCGCGAAGGATTT
GGATGCAGACACGTTCCCTCGAAA -> GATGCAGACACGTTCCCTCGAAAC
TAAGCTCTAGTTAGGGCGGATTTG -> AAGCTCTAGTTAGGGCGGATTTGG
CCATGGCTCAGTTGTTTTACTTCA -> CATGGCTCAGTTGTTTTACTTCAT
AAGATTGGTGCAGCCATGGCTCAG -> AGATTGGTGCAGCCATGGCTCAGT
CACATCGCGAAGGATTTTTTATCG -> ACATCGCGAAGGATTTTTTATCGA
GATCCGGGATGAATGATTATGGGT -> ATCCGGGATGAATGATTATGGGTC
CCGTGTGTCGAGCGTGGTGCTTCT -> CGTGTGTCGAGCGTGGTGCTTCTT
GGATGAACGTTGTCGTGTAAGGTA -> GATGAACGTTGTCGTGTAAGGTAG
CCTCGATTGCAACATCGGATGTAT -> CTCGATTGCAACATCGGATGTATT
ATAGACAATTTATACGACCTCCTA -> TAGACAATTTATACGACCTCCTAG
GATCTGAACAACAACGAGACCAGG -> ATCTGAACAACAACGAGACCAGGC
GCAGACACGTTCCCTCGAAACCCA -> CAGACACGTTCCCTCGAAACCCAC
TGGGATAGCTGTCACGGTTGTGAT -> GGGATAGCTGTCACGGTTGTGATA
AGACAGGGATTGGGTGGGTGCTCA -> GACAGGGATTGGGTGGGTGCTCAA
AGCAGCGGCATGACTATAGGATCG -> GCAGCGGCATGACTATAGGATCGT
AACCGCGCCGCCCTTCTAGGAGAC -> ACCGCGCCGCCCTTCTAGGAGACA
AGTGTGTAGTGGTAGAGGAGTTAG -> GTGTGTAGTGGTAGAGGAGTTAGA
TAACTTCCTTCATCTTGGTGATCC -> AACTTCCTTCATCTTGGTGATCCC
TAACCTAGCCCGTGGACCCATGGG -> AACCTAGCCCGTGGACCCATGGGC
GGTGTGTCCAGTGCTCCTAGTACT -> GTGTGTCCAGTGCTCCTAGTACTT
GTCATGGCTGGTGCCGGGGATGAA -> TCATGGCTGGTGCCGGGGATGAAC
CGCCCTTCTAGGAGACAGGGATTG -> GCCCTTCTAGGAGACAGGGATTGG
ACTCACTCGTTACGATGAAAACAG -> CTCACTCGTTACGATGAAAACAGA
CACATTACGTAAACTCGAGTAATC -> ACATTACGTAAACTCGAGTAATCT
CTGTCACGGTTGTGATATACCTTT -> TGTCACGGTTGTGATATACCTTTT
GGGCCTTTATCCCACCACAGGCGC -> GGCCTTTATCCCACCACAGGCGCT
CTCCAGGAATGTGCAGAAAATACT -> TCCAGGAATGTGCAGAAAATACTT
GTAAATCAGACTGCGACCGGTTAG -> TAAATCAGACTGCGACCGGTTAGG
TTACAGGGTTCCCGCGACGGCGCA -> TACAGGGTTCCCGCGACGGCGCAA
CGACCTCCTAGATCTGAACAACAA -> GACCTCCTAGATCTGAACAACAAC
AACCCACGCGATACGACAGATAGA -> ACCCACGCGATACGACAGATAGAC
CGTTACGATGAAAACAGACGGCCT -> GTTACGATGAAAACAGACGGCCTG
AGAAATTCAACCGCCGAGTGTGTA -> GAAATTCAACCGCCGAGTGTGTAG
GTTGTGATATACCTTTTTTGAAAC -> TTGTGATATACCTTTTTTGAAACA
TACTTCAAGTTCCACAATTAGTCG -> ACTTCAAGTTCCACAATTAGTCGT
CAGAAAACTCGGGGCCTCATGGCC -> AGAAAACTCGGGGCCTCATGGCCG
TGGATCGACCGATTAACCGCAGAT -> GGATCGACCGATTAACCGCAGATC
GGAGGTTACAACACAGAAATTCAA -> GAGGTTACAACACAGAAATTCAAC
CTATTTACCAGCCCCCTCACGCGG -> TATTTACCAGCCCCCTCACGCGGA
TTGGTACAACGATCCGGGATGAAT -> TGGTACAACGATCCGGGATGAATG
GTAATCTTGGTACAACGATCCGGG -> TAATCTTGGTACAACGATCCGGGA
CTCAGAAAACTCGGGGCCTCATGG -> TCAGAAAACTCGGGGCCTCATGGC
ATGACGGAGGTATTTTTTTGCTTT -> TGACGGAGGTATTTTTTTGCTTTC
GTCCGGGATTCGGTCCACCTACCA -> TCCGGGATTCGGTCCACCTACCAG
TAGCTTTTTACTGCCGGAGGGATC -> AGCTTTTTACTGCCGGAGGGATCC
TAACTGTTTAATCAGCGATACGGA -> AACTGTTTAATCAGCGATACGGAC
ATGAATGATTATGGGTCGTATGGA -> TGAATGATTATGGGTCGTATGGAA
TCACTCGTTACGATGAAAACAGAC -> CACTCGTTACGATGAAAACAGACG
TAACCGCAGATCGTCGGGAATTAA -> AACCGCAGATCGTCGGGAATTAAC
ATTTGTCTGGAACCGCGCCGCCCT -> TTTGTCTGGAACCGCGCCGCCCTT
AATTAGTCGTCCGTCCAGCAGACC -> ATTAGTCGTCCGTCCAGCAGACCG
AGCTGTCACGGTTGTGATATACCT -> GCTGTCACGGTTGTGATATACCTT
CGGAATTCCTGCAATATTGGAGAC -> GGAATTCCTGCAATATTGGAGACC
ACAATTTATACGACCTCCTAGATC -> CAATTTATACGACCTCCTAGATCT
TCTAACTACTGTGACCATTATCTC -> CTAACTACTGTGACCATTATCTCG
CTACTTAGCTTTTTACTGCCGGAG -> TACTTAGCTTTTTACTGCCGGAGG
GACAGTCACTAGATAGACAATTTA -> ACAGTCACTAGATAGACAATTTAT
ACTTCCTTCATCTTGGTGATCCCG -> CTTCCTTCATCTTGGTGATCCCGT
ACCTGGCGAAGCAGCGGCATGACT -> CCTGGCGAAGCAGCGGCATGACTA
TTTTTTGCTTTCCCTCCCGTAAAT -> TTTTTGCTTTCCCTCCCGTAAATC
CGCCCGGGTAGGGCTACAAATGGT -> GCCCGGGTAGGGCTACAAATGGTT
