AAAAAACGAGA -> AAAAACGAGAC
AAAAACCGAGA -> AAAACCGAGAC
AAAAACGAGAC -> AAAACGAGACT
AAAAAGTTAGC -> AAAAGTTAGCA
AAAACCACTGC -> AAACCACTGCC
AAAACCGAGAC -> AAACCGAGACG
AAAACGAGACT -> AAACGAGACTA
AAAACTCTCTC -> AAACTCTCTCA
AAAAGCGTGAC -> AAAGCGTGACT
AAAAGGTGAGA -> AAAGGTGAGAA
AAAAGTGCCCG -> AAAGTGCCCGA
AAAAGTTAGCA -> AAAGTTAGCAG
AAAATATAGGA -> AAATATAGGAG
AAACATCAGTA -> AACATCAGTAT
AAACCACTGCC -> AACCACTGCCT
AAACCCATGAT -> AACCCATGATG
AAACCGAGACG -> AACCGAGACGT
AAACGAGACTA -> AACGAGACTAA
AAACTCTCTCA -> AACTCTCTCAG
AAACTTGTATT -> AACTTGTATTA
AAAGCGATATA -> AAGCGATATAA
AAAGCGTGACT -> AAGCGTGACTT
AAAGGTGAGAA -> AAGGTGAGAAA
AAAGGTGGCAC -> AAGGTGGCACT
AAAGTCCTTGT -> AAGTCCTTGTG
AAAGTGCCCGA -> AAGTGCCCGAA
AAAGTTAGCAG -> AAGTTAGCAGA
AAAGTTTAGCA -> AAGTTTAGCAC
AAATATAGGAG -> AATATAGGAGA
AAATCAGTATA -> AATCAGTATAC
AAATGTCTCCA -> AATGTCTCCAT
AAATTTGGTCC -> AATTTGGTCCC
AACACAGGCCG -> ACACAGGCCGG
AACACCCGTGA -> ACACCCGTGAT
AACACTGCTTA -> ACACTGCTTAC
AACATCAGTAT -> ACATCAGTATT
AACATGAACTC -> ACATGAACTCA
AACCACTGCCT -> ACCACTGCCTC
AACCCATGATG -> ACCCATGATGT
AACCGAGACGT -> ACCGAGACGTA
AACCTATTGCT -> ACCTATTGCTC
AACGAGACTAA -> ACGAGACTAAT
AACGCCAAATG -> ACGCCAAATGT
AACGCGACCCG -> ACGCGACCCGT
AACGGAGGGCC -> ACGGAGGGCCC
AACGTAACTTC -> ACGTAACTTCA
AACGTAGACCA -> ACGTAGACCAA
AACGTAGGGTA -> ACGTAGGGTAT
AACTAATTATG -> ACTAATTATGA
AACTATCGCAT -> ACTATCGCATC
AACTATCGGGA -> ACTATCGGGAC
AACTATTGGTT -> ACTATTGGTTC
AACTCAAAACC -> ACTCAAAACCA
AACTCTCACCT -> ACTCTCACCTC
AACTCTCTCAG -> ACTCTCTCAGC
AACTGGCATGA -> ACTGGCATGAC
AACTGGCGGCC -> ACTGGCGGCCG
AACTTAGTTAG -> ACTTAGTTAGC
AACTTATTGTA -> ACTTATTGTAG
AACTTCAACAC -> ACTTCAACACA
AACTTGTATTA -> ACTTGTATTAC
AAGAAAAGGTG -> AGAAAAGGTGA
AAGAAGAAAAG -> AGAAGAAAAGG
AAGAAGGGCCA -> AGAAGGGCCAG
AAGAATGGAGG -> AGAATGGAGGT
AAGACAGGCTA -> AGACAGGCTAT
AAGATGGCCCG -> AGATGGCCCGG
AAGCAGGGTTT -> AGCAGGGTTTT
AAGCATACTGG -> AGCATACTGGT
AAGCGATATAA -> AGCGATATAAC
AAGCGTGACTT -> AGCGTGACTTG
AAGCTCTCGGC -> AGCTCTCGGCT
AAGCTTCTAAA -> AGCTTCTAAAA
AAGGACTCGGC -> AGGACTCGGCT
AAGGAGGATTT -> AGGAGGATTTC
AAGGGCCAGTC -> AGGGCCAGTCT
AAGGTAACGTA -> AGGTAACGTAG
AAGGTGAGAAA -> AGGTGAGAAAG
AAGGTGGCACT -> AGGTGGCACTT
AAGTACTAATA -> AGTACTAATAC
AAGTATATTTA -> AGTATATTTAA
AAGTCCTTGTG -> AGTCCTTGTGA
AAGTGCCCGAA -> AGTGCCCGAAC
AAGTTAATACT -> AGTTAATACTA
AAGTTAGCAGA -> AGTTAGCAGAA
AAGTTCGCTTT -> AGTTCGCTTTT
AAGTTTAAACC -> AGTTTAAACCC
AAGTTTAGCAC -> AGTTTAGCACA
AAGTTTTGGTT -> AGTTTTGGTTG
AATAAATTTGG -> ATAAATTTGGT
AATAAGAAGGG -> ATAAGAAGGGC
AATACATTGGT -> ATACATTGGTG
AATACTACCAA -> ATACTACCAAA
AATAGTCTACG -> ATAGTCTACGT
AATATACATTC -> ATATACATTCA
AATATAGGAGA -> ATATAGGAGAT
AATCAGTATAC -> ATCAGTATACT
AATCATCCGAG -> ATCATCCGAGT
AATCGGGTGAT -> ATCGGGTGATG
AATGCATAGTG -> ATGCATAGTGA
AATGGAGGTCT -> ATGGAGGTCTG
AATGTCTCCAT -> ATGTCTCCATT
AATTAGACTAT -> ATTAGACTATA
AATTATGAGAA -> ATTATGAGAAA
AATTGCCGCCG -> ATTGCCGCCGA
AATTTGGTCCC -> ATTTGGTCCCA
ACAAAGTCCTT -> CAAAGTCCTTG
ACAACTGGCAT -> CAACTGGCATG
ACAAGTTTAAA -> CAAGTTTAAAC
ACACAAGTTTA -> CACAAGTTTAA
ACACAGGCCGG -> CACAGGCCGGA
ACACCCCGACC -> CACCCCGACCA
ACACCCGTGAT -> CACCCGTGATG
ACACCTTTCGT -> CACCTTTCGTC
ACACTACTCCC -> CACTACTCCCC
ACACTGCTTAC -> CACTGCTTACC
ACAGGCCGGAT -> CAGGCCGGATT
ACAGGCTATAG -> CAGGCTATAGA
ACAGGGATATT -> CAGGGATATTA
ACAGGTGTGTA -> CAGGTGTGTAT
ACATCAGTATT -> CATCAGTATTC
ACATCATGTAT -> CATCATGTATG
ACATCCTCACC -> CATCCTCACCG
ACATGAACTCA -> CATGAACTCAA
ACATTCAGAAG -> CATTCAGAAGC
ACATTCTAACG -> CATTCTAACGG
ACATTGGTGTG -> CATTGGTGTGG
ACCAAAACTCT -> CCAAAACTCTC
ACCAAAAGTGC -> CCAAAAGTGCC
ACCAAAATATA -> CCAAAATATAG
ACCAACTATTG -> CCAACTATTGG
ACCAAGGAGGA -> CCAAGGAGGAT
ACCAATAAGAA -> CCAATAAGAAG
ACCACGCATAG -> CCACGCATAGC
ACCACTGCCTC -> CCACTGCCTCT
ACCATCATACA -> CCATCATACAC
ACCCATGATGT -> CCCATGATGTG
ACCCCCGTGAT -> CCCCCGTGATT
ACCCCGACCAA -> CCCCGACCAAA
ACCCGTACCCT -> CCCGTACCCTA
ACCCGTGATGG -> CCCGTGATGGG
ACCCTATATAA -> CCCTATATAAA
ACCCTTGAAGT -> CCCTTGAAGTT
ACCGACCTGCT -> CCGACCTGCTC
ACCGAGACGTA -> CCGAGACGTAG
ACCGGCTTAAT -> CCGGCTTAATA
ACCGGGTATTC -> CCGGGTATTCC
ACCGTACTGCC -> CCGTACTGCCG
ACCGTGGGCTT -> CCGTGGGCTTA
ACCTATTGCTC -> CCTATTGCTCA
ACCTCCATACG -> CCTCCATACGT
ACCTGCTCCAT -> CCTGCTCCATA
ACCTTCTTCTT -> CCTTCTTCTTG
ACCTTGCAATT -> CCTTGCAATTA
ACCTTTCGTCC -> CCTTTCGTCCG
ACCTTTGGTCT -> CCTTTGGTCTA
ACGAACGCCAA -> CGAACGCCAAA
ACGAACTTATT -> CGAACTTATTG
ACGAGACTAAT -> CGAGACTAATC
ACGATCACCGG -> CGATCACCGGC
ACGCAATAGTC -> CGCAATAGTCT
ACGCAGAGCAC -> CGCAGAGCACA
ACGCATAGCCA -> CGCATAGCCAA
ACGCCAAATGT -> CGCCAAATGTC
ACGCGACCCGT -> CGCGACCCGTA
ACGCGAGGGAC -> CGCGAGGGACA
ACGCGTGGGAC -> CGCGTGGGACT
ACGGAGGGCCC -> CGGAGGGCCCT
ACGGCGGCCTC -> CGGCGGCCTCG
ACGGCTTAAGA -> CGGCTTAAGAA
ACGTAACTTCA -> CGTAACTTCAA
ACGTACTTGAA -> CGTACTTGAAA
ACGTAGACCAA -> CGTAGACCAAG
ACGTAGCTTAA -> CGTAGCTTAAC
ACGTAGGGTAT -> CGTAGGGTATA
ACGTAGTGTCC -> CGTAGTGTCCC
ACGTCCCGAGG -> CGTCCCGAGGA
ACGTCGCTTTA -> CGTCGCTTTAA
ACGTCTAAGCA -> CGTCTAAGCAT
ACTAAGTTTTG -> CTAAGTTTTGG
ACTAATACATT -> CTAATACATTG
ACTAATCATCC -> CTAATCATCCG
ACTAATCGGGT -> CTAATCGGGTG
ACTAATTATGA -> CTAATTATGAG
ACTACCAAAAC -> CTACCAAAACT
ACTACTCCCCG -> CTACTCCCCGC
ACTATAGATGA -> CTATAGATGAC
ACTATCACCAA -> CTATCACCAAC
ACTATCGCATC -> CTATCGCATCG
ACTATCGGGAC -> CTATCGGGACG
ACTATTGCCAA -> CTATTGCCAAG
ACTATTGGTTC -> CTATTGGTTCA
ACTCAAAACCA -> CTCAAAACCAC
ACTCAAGATGG -> CTCAAGATGGC
ACTCAGCCCCG -> CTCAGCCCCGC
ACTCCCCGCTT -> CTCCCCGCTTG
ACTCCGGTGTC -> CTCCGGTGTCT
ACTCGGCTCGA -> CTCGGCTCGAA
ACTCGTTTTGA -> CTCGTTTTGAG
ACTCTCACCTC -> CTCTCACCTCC
ACTCTCTCAGC -> CTCTCTCAGCC
ACTGATTCCTA -> CTGATTCCTAT
ACTGCCGAGTC -> CTGCCGAGTCG
ACTGCCTCTTA -> CTGCCTCTTAT
ACTGCTTACCA -> CTGCTTACCAA
ACTGGCATGAC -> CTGGCATGACC
ACTGGCGGCCG -> CTGGCGGCCGT
ACTGGTCGTGG -> CTGGTCGTGGG
ACTTACCTTGC -> CTTACCTTGCA
ACTTAGCAAAC -> CTTAGCAAACA
ACTTAGGCAGC -> CTTAGGCAGCG
ACTTAGTTAGC -> CTTAGTTAGCT
ACTTATTGTAG -> CTTATTGTAGT
ACTTCAACACA -> CTTCAACACAG
ACTTGAAAGCG -> CTTGAAAGCGA
ACTTGATTGAT -> CTTGATTGATA
ACTTGTATTAC -> CTTGTATTACA
ACTTGTTGATC -> CTTGTTGATCG
ACTTTGCCTAG -> CTTTGCCTAGA
ACTTTGTGTAA -> CTTTGTGTAAC
ACTTTTCAGTC -> CTTTTCAGTCC
AGAAAAGGTGA -> GAAAAGGTGAG
AGAAACTTGTA -> GAAACTTGTAT
AGAAAGGTGGC -> GAAAGGTGGCA
AGAACATGAAC -> GAACATGAACT
AGAACTGGCGG -> GAACTGGCGGC
AGAAGAAAAGG -> GAAGAAAAGGT
AGAAGCTTCTA -> GAAGCTTCTAA
AGAAGGGCCAG -> GAAGGGCCAGT
AGAATGGAGGT -> GAATGGAGGTC
AGACAACTGGC -> GACAACTGGCA
AGACAGGCTAT -> GACAGGCTATA
AGACCAAGGAG -> GACCAAGGAGG
AGACCGTGGGC -> GACCGTGGGCT
AGACGTAGTGT -> GACGTAGTGTC
AGACTAATCGG -> GACTAATCGGG
AGACTATAGAT -> GACTATAGATG
AGACTTTTCAG -> GACTTTTCAGT
AGAGATTAACT -> GAGATTAACTT
AGAGCACACCC -> GAGCACACCCC
AGATCCCTTGA -> GATCCCTTGAT
AGATGAAGGTA -> GATGAAGGTAA
AGATGACTAAT -> GATGACTAATC
AGATGCATATG -> GATGCATATGA
AGATGGCCCGG -> GATGGCCCGGT
AGATTAACTTA -> GATTAACTTAG
AGATTCACCCC -> GATTCACCCCC
AGATTTACCAC -> GATTTACCACG
AGCAAACATCA -> GCAAACATCAG
AGCACAAAGTC -> GCACAAAGTCC
AGCACACCCCG -> GCACACCCCGA
AGCACAGGGAT -> GCACAGGGATA
AGCACGATCAC -> GCACGATCACC
AGCAGAACTGG -> GCAGAACTGGC
AGCAGGGTTTT -> GCAGGGTTTTA
AGCATACTGGT -> GCATACTGGTC
AGCCAAGTACT -> GCCAAGTACTA
AGCCCCGCCGC -> GCCCCGCCGCC
AGCCCCGCGTG -> GCCCCGCGTGA
AGCCCGAAAAA -> GCCCGAAAAAG
AGCCGCCTAGT -> GCCGCCTAGTG
AGCGATATAAC -> GCGATATAACC
AGCGCCTCACG -> GCGCCTCACGA
AGCGGATCTCC -> GCGGATCTCCA
AGCGTGACTTG -> GCGTGACTTGA
AGCTAGCACGA -> GCTAGCACGAT
AGCTCTCGGCT -> GCTCTCGGCTA
AGCTTAACTAT -> GCTTAACTATC
AGCTTCTAAAA -> GCTTCTAAAAA
AGCTTGTCGCC -> GCTTGTCGCCC
AGGAATGCATA -> GGAATGCATAG
AGGACTCGGCT -> GGACTCGGCTC
AGGAGATTTAC -> GGAGATTTACC
AGGAGCTTGTC -> GGAGCTTGTCG
AGGAGGATTTC -> GGAGGATTTCT
AGGAGTGTTTG -> GGAGTGTTTGC
AGGATTTCTGA -> GGATTTCTGAC
AGGCAGCGCCT -> GGCAGCGCCTC
AGGCCGGATTC -> GGCCGGATTCA
AGGCTATAGAT -> GGCTATAGATG
AGGGACACAAG -> GGGACACAAGT
AGGGACGTAGC -> GGGACGTAGCT
AGGGATATTAC -> GGGATATTACC
AGGGCATCTGG -> GGGCATCTGGC
AGGGCCAGTCT -> GGGCCAGTCTT
AGGGCCCTGAT -> GGGCCCTGATG
AGGGTATAGGT -> GGGTATAGGTA
AGGGTTTTACT -> GGGTTTTACTC
AGGTAACGTAG -> GGTAACGTAGA
AGGTACGCAGA -> GGTACGCAGAG
AGGTCTCCGTG -> GGTCTCCGTGG
AGGTCTGCCAG -> GGTCTGCCAGC
AGGTGAGAAAG -> GGTGAGAAAGG
AGGTGGCACTT -> GGTGGCACTTA
AGGTGTGTATA -> GGTGTGTATAG
AGTACTAATAC -> GTACTAATACA
AGTATACTAAG -> GTATACTAAGT
AGTATATTTAA -> GTATATTTAAC
AGTATTCGGTT -> GTATTCGGTTC
AGTCAGTTATT -> GTCAGTTATTG
AGTCATAGGGC -> GTCATAGGGCA
AGTCCGACTTG -> GTCCGACTTGT
AGTCCTTGTGA -> GTCCTTGTGAC
AGTCGCCGAGC -> GTCGCCGAGCC
AGTCTACGTCG -> GTCTACGTCGC
AGTCTTATTTG -> GTCTTATTTGG
AGTGACTTTGT -> GTGACTTTGTG
AGTGCACCCTT -> GTGCACCCTTG
AGTGCCCGAAC -> GTGCCCGAACT
AGTGGCCGAGA -> GTGGCCGAGAC
AGTGTCCCATT -> GTGTCCCATTG
AGTGTGGACAT -> GTGTGGACATT
AGTGTTTGCAT -> GTGTTTGCATA
AGTTAATACTA -> GTTAATACTAC
AGTTAGCAGAA -> GTTAGCAGAAC
AGTTAGCTAGC -> GTTAGCTAGCA
AGTTATTGCCC -> GTTATTGCCCT
AGTTCGCTTTT -> GTTCGCTTTTT
AGTTGAGACAA -> GTTGAGACAAC
AGTTGCTGCAC -> GTTGCTGCACT
AGTTTAAACCC -> GTTTAAACCCA
AGTTTAGCACA -> GTTTAGCACAG
AGTTTTGGTTG -> GTTTTGGTTGT
ATAAATCAGTA -> TAAATCAGTAT
ATAAATTTGGT -> TAAATTTGGTC
ATAACCTATTG -> TAACCTATTGC
ATAACTAATTA -> TAACTAATTAT
ATAAGAAGGGC -> TAAGAAGGGCC
ATAAGACAGGC -> TAAGACAGGCT
ATAAGGACTCG -> TAAGGACTCGG
ATACACCTTTC -> TACACCTTTCG
ATACATTCAGA -> TACATTCAGAA
ATACATTGGTG -> TACATTGGTGT
ATACCATCATA -> TACCATCATAC
ATACGTCCCGA -> TACGTCCCGAG
ATACGTCTAAG -> TACGTCTAAGC
ATACTAAGTTT -> TACTAAGTTTT
ATACTACCAAA -> TACTACCAAAA
ATACTGGTCGT -> TACTGGTCGTG
ATACTTAGCAA -> TACTTAGCAAA
ATAGATGACTA -> TAGATGACTAA
ATAGATGCATA -> TAGATGCATAT
ATAGCACAAAG -> TAGCACAAAGT
ATAGCCAAGTA -> TAGCCAAGTAC
ATAGGAGATTT -> TAGGAGATTTA
ATAGGGCATCT -> TAGGGCATCTG
ATAGGTACGCA -> TAGGTACGCAG
ATAGGTCTCCG -> TAGGTCTCCGT
ATAGTCTACGT -> TAGTCTACGTC
ATAGTGACTTT -> TAGTGACTTTG
ATAGTTGCTGC -> TAGTTGCTGCA
ATATAAATCAG -> TATAAATCAGT
ATATAACCTAT -> TATAACCTATT
ATATACATTCA -> TATACATTCAG
ATATAGGAGAT -> TATAGGAGATT
ATATGAGTGTG -> TATGAGTGTGG
ATATGCACTTA -> TATGCACTTAC
ATATTACCTTC -> TATTACCTTCT
ATATTTAACTC -> TATTTAACTCT
ATCACCAACTA -> TCACCAACTAT
ATCACCGGCTT -> TCACCGGCTTA
ATCACGGCTTA -> TCACGGCTTAA
ATCAGTATACT -> TCAGTATACTA
ATCAGTATTCG -> TCAGTATTCGG
ATCATACACCT -> TCATACACCTT
ATCATCCCTCA -> TCATCCCTCAT
ATCATCCGAGT -> TCATCCGAGTC
ATCATGTATGA -> TCATGTATGAC
ATCCCTCATCG -> TCCCTCATCGA
ATCCCTTGATA -> TCCCTTGATAA
ATCCGAGTCAT -> TCCGAGTCATA
ATCCTCACCGG -> TCCTCACCGGG
ATCGACTATCA -> TCGACTATCAC
ATCGCATCGGT -> TCGCATCGGTG
ATCGCCTGGTA -> TCGCCTGGTAA
ATCGGGACGCG -> TCGGGACGCGA
ATCGGGTGATG -> TCGGGTGATGT
ATCGGTGACGC -> TCGGTGACGCG
ATCTCCACTCA -> TCTCCACTCAG
ATCTGCGGTGA -> TCTGCGGTGAG
ATCTGGCCCCC -> TCTGGCCCCCG
ATGAACTCAAA -> TGAACTCAAAA
ATGAAGGTAAC -> TGAAGGTAACG
ATGACCGACCT -> TGACCGACCTG
ATGACCGTACT -> TGACCGTACTG
ATGACTAATCA -> TGACTAATCAT
ATGAGAAACTT -> TGAGAAACTTG
ATGAGTGTGGA -> TGAGTGTGGAC
ATGATGTGGGG -> TGATGTGGGGA
ATGCACTTACC -> TGCACTTACCT
ATGCATAGTGA -> TGCATAGTGAC
ATGCATATGAG -> TGCATATGAGT
ATGCCCACCTT -> TGCCCACCTTT
ATGCTACGGCG -> TGCTACGGCGG
ATGCTGGTCTA -> TGCTGGTCTAG
ATGGAGGTCTG -> TGGAGGTCTGC
ATGGCCCGGTT -> TGGCCCGGTTC
ATGGGCCTTTC -> TGGGCCTTTCA
ATGGTTGGAGG -> TGGTTGGAGGG
ATGTATGACCG -> TGTATGACCGA
ATGTCTCCATT -> TGTCTCCATTC
ATGTCTTCCAG -> TGTCTTCCAGA
ATGTGGGGATG -> TGTGGGGATGT
ATGTTCCCAAC -> TGTTCCCAACA
ATTAACTTAGT -> TTAACTTAGTT
ATTACACTACT -> TTACACTACTC
ATTACCTTCTT -> TTACCTTCTTC
ATTAGACTATA -> TTAGACTATAG
ATTATGAGAAA -> TTATGAGAAAC
ATTCAAAGTTT -> TTCAAAGTTTA
ATTCACCAAAA -> TTCACCAAAAT
ATTCACCCCCG -> TTCACCCCCGT
ATTCAGAAGCT -> TTCAGAAGCTT
ATTCATAACTA -> TTCATAACTAA
ATTCATAGTTG -> TTCATAGTTGC
ATTCCAGATTC -> TTCCAGATTCA
ATTCCTATCAT -> TTCCTATCATC
ATTCGGAATAT -> TTCGGAATATA
ATTCGGTTCAT -> TTCGGTTCATG
ATTCTAACGGA -> TTCTAACGGAG
ATTCTCGTTTT -> TTCTCGTTTTT
ATTGATACCAT -> TTGATACCATC
ATTGCCAAGAA -> TTGCCAAGAAG
ATTGCCCTCTG -> TTGCCCTCTGG
ATTGCCGCCGA -> TTGCCGCCGAA
ATTGCGATTCA -> TTGCGATTCAA
ATTGCTCATTC -> TTGCTCATTCA
ATTGGTGTGGT -> TTGGTGTGGTC
ATTGGTTCATA -> TTGGTTCATAC
ATTGTACAGGT -> TTGTACAGGTG
ATTGTAGTGGC -> TTGTAGTGGCC
ATTTAACTCTC -> TTTAACTCTCA
ATTTACCACGC -> TTTACCACGCA
ATTTCTGACAT -> TTTCTGACATC
ATTTGGGTACA -> TTTGGGTACAT
ATTTGGTCCCA -> TTTGGTCCCAT
CAAAACCACTG -> AAAACCACTGC
CAAAACTCTCT -> AAAACTCTCTC
CAAAAGTGCCC -> AAAAGTGCCCG
CAAAATATAGG -> AAAATATAGGA
CAAACATCAGT -> AAACATCAGTA
CAAAGTCCTTG -> AAAGTCCTTGT
CAAAGTTTAGC -> AAAGTTTAGCA
CAAATGTCTCC -> AAATGTCTCCA
CAACACAGGCC -> AACACAGGCCG
CAACACTGCTT -> AACACTGCTTA
CAACTATTGGT -> AACTATTGGTT
CAACTGGCATG -> AACTGGCATGA
CAAGAAGAAAA -> AAGAAGAAAAG
CAAGATGGCCC -> AAGATGGCCCG
CAAGGAGGATT -> AAGGAGGATTT
CAAGTACTAAT -> AAGTACTAATA
CAAGTATATTT -> AAGTATATTTA
CAAGTTAATAC -> AAGTTAATACT
CAAGTTTAAAC -> AAGTTTAAACC
CAATAAGAAGG -> AATAAGAAGGG
CAATAGTCTAC -> AATAGTCTACG
CAATTAGACTA -> AATTAGACTAT
CACAAAGTCCT -> ACAAAGTCCTT
CACAAGTTTAA -> ACAAGTTTAAA
CACACCCCGAC -> ACACCCCGACC
CACAGGCCGGA -> ACAGGCCGGAT
CACAGGGATAT -> ACAGGGATATT
CACCAAAATAT -> ACCAAAATATA
CACCAACTATT -> ACCAACTATTG
CACCCCCGTGA -> ACCCCCGTGAT
CACCCCGACCA -> ACCCCGACCAA
CACCCGTGATG -> ACCCGTGATGG
CACCCTTGAAG -> ACCCTTGAAGT
CACCGGCTTAA -> ACCGGCTTAAT
CACCGGGTATT -> ACCGGGTATTC
CACCTCCATAC -> ACCTCCATACG
CACCTTTCGTC -> ACCTTTCGTCC
CACCTTTGGTC -> ACCTTTGGTCT
CACGAACGCCA -> ACGAACGCCAA
CACGAACTTAT -> ACGAACTTATT
CACGATCACCG -> ACGATCACCGG
CACGCATAGCC -> ACGCATAGCCA
CACGGCTTAAG -> ACGGCTTAAGA
CACTACTCCCC -> ACTACTCCCCG
CACTATTGCCA -> ACTATTGCCAA
CACTCAGCCCC -> ACTCAGCCCCG
CACTCCGGTGT -> ACTCCGGTGTC
CACTGCCTCTT -> ACTGCCTCTTA
CACTGCTTACC -> ACTGCTTACCA
CACTTACCTTG -> ACTTACCTTGC
CACTTAGGCAG -> ACTTAGGCAGC
CAGAACTGGCG -> AGAACTGGCGG
CAGAAGCTTCT -> AGAAGCTTCTA
CAGACCGTGGG -> AGACCGTGGGC
CAGAGCACACC -> AGAGCACACCC
CAGATTCACCC -> AGATTCACCCC
CAGCCCCGCCG -> AGCCCCGCCGC
CAGCCCCGCGT -> AGCCCCGCGTG
CAGCCGCCTAG -> AGCCGCCTAGT
CAGCGCCTCAC -> AGCGCCTCACG
CAGGAATGCAT -> AGGAATGCATA
CAGGCCGGATT -> AGGCCGGATTC
CAGGCTATAGA -> AGGCTATAGAT
CAGGGATATTA -> AGGGATATTAC
CAGGGTTTTAC -> AGGGTTTTACT
CAGGTGTGTAT -> AGGTGTGTATA
CAGTATACTAA -> AGTATACTAAG
CAGTATTCGGT -> AGTATTCGGTT
CAGTCCGACTT -> AGTCCGACTTG
CAGTCTTATTT -> AGTCTTATTTG
CAGTTATTGCC -> AGTTATTGCCC
CATAACTAATT -> ATAACTAATTA
CATACACCTTT -> ATACACCTTTC
CATACGTCTAA -> ATACGTCTAAG
CATACTGGTCG -> ATACTGGTCGT
CATACTTAGCA -> ATACTTAGCAA
CATAGCACAAA -> ATAGCACAAAG
CATAGCCAAGT -> ATAGCCAAGTA
CATAGGGCATC -> ATAGGGCATCT
CATAGTGACTT -> ATAGTGACTTT
CATAGTTGCTG -> ATAGTTGCTGC
CATATGAGTGT -> ATATGAGTGTG
CATATGCACTT -> ATATGCACTTA
CATCAGTATTC -> ATCAGTATTCG
CATCATACACC -> ATCATACACCT
CATCATGTATG -> ATCATGTATGA
CATCCCTCATC -> ATCCCTCATCG
CATCCGAGTCA -> ATCCGAGTCAT
CATCCTCACCG -> ATCCTCACCGG
CATCGACTATC -> ATCGACTATCA
CATCGGTGACG -> ATCGGTGACGC
CATCTGCGGTG -> ATCTGCGGTGA
CATCTGGCCCC -> ATCTGGCCCCC
CATGAACTCAA -> ATGAACTCAAA
CATGACCGTAC -> ATGACCGTACT
CATGATGTGGG -> ATGATGTGGGG
CATGGTTGGAG -> ATGGTTGGAGG
CATGTATGACC -> ATGTATGACCG
CATTCACCAAA -> ATTCACCAAAA
CATTCAGAAGC -> ATTCAGAAGCT
CATTCATAGTT -> ATTCATAGTTG
CATTCTAACGG -> ATTCTAACGGA
CATTGGTGTGG -> ATTGGTGTGGT
CATTGTACAGG -> ATTGTACAGGT
CCAAAACTCTC -> CAAAACTCTCT
CCAAAAGTGCC -> CAAAAGTGCCC
CCAAAATATAG -> CAAAATATAGG
CCAAATGTCTC -> CAAATGTCTCC
CCAACACTGCT -> CAACACTGCTT
CCAACTATTGG -> CAACTATTGGT
CCAAGAAGAAA -> CAAGAAGAAAA
CCAAGGAGGAT -> CAAGGAGGATT
CCAAGTACTAA -> CAAGTACTAAT
CCAATAAGAAG -> CAATAAGAAGG
CCACCTTTGGT -> CACCTTTGGTC
CCACGAACTTA -> CACGAACTTAT
CCACGCATAGC -> CACGCATAGCC
CCACTCAGCCC -> CACTCAGCCCC
CCACTGCCTCT -> CACTGCCTCTT
CCAGACCGTGG -> CAGACCGTGGG
CCAGATTCACC -> CAGATTCACCC
CCAGCCGCCTA -> CAGCCGCCTAG
CCAGTCTTATT -> CAGTCTTATTT
CCATACGTCTA -> CATACGTCTAA
CCATAGCACAA -> CATAGCACAAA
CCATCATACAC -> CATCATACACC
CCATCTGCGGT -> CATCTGCGGTG
CCATGATGTGG -> CATGATGTGGG
CCATTCACCAA -> CATTCACCAAA
CCATTGTACAG -> CATTGTACAGG
CCCAACACTGC -> CCAACACTGCT
CCCACCTTTGG -> CCACCTTTGGT
CCCACGAACTT -> CCACGAACTTA
CCCATCTGCGG -> CCATCTGCGGT
CCCATGATGTG -> CCATGATGTGG
CCCATTGTACA -> CCATTGTACAG
CCCCCGGATGC -> CCCCGGATGCT
CCCCCGTGATT -> CCCCGTGATTC
CCCCGACCAAA -> CCCGACCAAAA
CCCCGCCGCCG -> CCCGCCGCCGA
CCCCGCGTGAG -> CCCGCGTGAGC
CCCCGCTTGCT -> CCCGCTTGCTA
CCCCGGATGCT -> CCCGGATGCTA
CCCCGTGATTC -> CCCGTGATTCG
CCCCTTGTAGA -> CCCTTGTAGAT
CCCGAAAAAGT -> CCGAAAAAGTT
CCCGAACTATC -> CCGAACTATCG
CCCGACCAAAA -> CCGACCAAAAG
CCCGAGGAGCT -> CCGAGGAGCTT
CCCGCCGCCGA -> CCGCCGCCGAC
CCCGCGTGAGC -> CCGCGTGAGCG
CCCGCTTGCTA -> CCGCTTGCTAA
CCCGGATGCTA -> CCGGATGCTAC
CCCGGTATAAG -> CCGGTATAAGA
CCCGGTTCCTT -> CCGGTTCCTTG
CCCGTACCCTA -> CCGTACCCTAT
CCCGTGATGGG -> CCGTGATGGGC
CCCGTGATTCG -> CCGTGATTCGG
CCCTATATAAA -> CCTATATAAAT
CCCTCATCGAC -> CCTCATCGACT
CCCTCTGGCGC -> CCTCTGGCGCG
CCCTGATGCCC -> CCTGATGCCCA
CCCTTGAAGTT -> CCTTGAAGTTC
CCCTTGATAAG -> CCTTGATAAGG
CCCTTGTAGAT -> CCTTGTAGATG
CCGAAAAAGTT -> CGAAAAAGTTA
CCGAACTATCG -> CGAACTATCGC
CCGAAGCTCTC -> CGAAGCTCTCG
CCGACCAAAAG -> CGACCAAAAGT
CCGACCTGCTC -> CGACCTGCTCC
CCGACGCAATA -> CGACGCAATAG
CCGACTTGTTG -> CGACTTGTTGA
CCGAGACGTAG -> CGAGACGTAGT
CCGAGACTTTT -> CGAGACTTTTC
CCGAGCCCGAA -> CGAGCCCGAAA
CCGAGGAGCTT -> CGAGGAGCTTG
CCGAGTCATAG -> CGAGTCATAGG
CCGAGTCGCCG -> CGAGTCGCCGA
CCGCCCACGAA -> CGCCCACGAAC
CCGCCGAAGCT -> CGCCGAAGCTC
CCGCCGACGCA -> CGCCGACGCAA
CCGCCGCCGAC -> CGCCGCCGACG
CCGCCTAGTGC -> CGCCTAGTGCA
CCGCGTGAGCG -> CGCGTGAGCGG
CCGCTTGCTAA -> CGCTTGCTAAA
CCGGATGCTAC -> CGGATGCTACG
CCGGATTCATA -> CGGATTCATAA
CCGGCTTAATA -> CGGCTTAATAA
CCGGGTATTCC -> CGGGTATTCCA
CCGGTATAAGA -> CGGTATAAGAC
CCGGTGTCTTG -> CGGTGTCTTGT
CCGGTTCCTTG -> CGGTTCCTTGG
CCGTACCCTAT -> CGTACCCTATA
CCGTACTGCCG -> CGTACTGCCGA
CCGTGATGGGC -> CGTGATGGGCC
CCGTGATTCGG -> CGTGATTCGGA
CCGTGGGCTTA -> CGTGGGCTTAA
CCGTGGGCTTG -> CGTGGGCTTGG
CCTAGAACATG -> CTAGAACATGA
CCTAGTGCACC -> CTAGTGCACCC
CCTATATAAAT -> CTATATAAATC
CCTATCATCCC -> CTATCATCCCT
CCTATTGCTCA -> CTATTGCTCAT
CCTCACCGGGT -> CTCACCGGGTA
CCTCACGAACG -> CTCACGAACGC
CCTCATCGACT -> CTCATCGACTA
CCTCCATACGT -> CTCCATACGTC
CCTCGGCAAGT -> CTCGGCAAGTT
CCTCGTGATTC -> CTCGTGATTCT
CCTCTGGCGCG -> CTCTGGCGCGC
CCTCTTATGCT -> CTCTTATGCTG
CCTGATGCCCA -> CTGATGCCCAC
CCTGCTCCATA -> CTGCTCCATAG
CCTGGTAACAC -> CTGGTAACACC
CCTTATCACGG -> CTTATCACGGC
CCTTCTTCTTG -> CTTCTTCTTGA
CCTTGAAGTTC -> CTTGAAGTTCG
CCTTGATAAGG -> CTTGATAAGGA
CCTTGCAATTA -> CTTGCAATTAG
CCTTGGGGGAG -> CTTGGGGGAGG
CCTTGTAGATG -> CTTGTAGATGA
CCTTGTGACGT -> CTTGTGACGTA
CCTTTCAGGAA -> CTTTCAGGAAT
CCTTTCGTCCG -> CTTTCGTCCGC
CCTTTGGTCTA -> CTTTGGTCTAC
CGAAAAAGTTA -> GAAAAAGTTAG
CGAACGCCAAA -> GAACGCCAAAT
CGAACGTAACT -> GAACGTAACTT
CGAACTATCGC -> GAACTATCGCA
CGAACTTATTG -> GAACTTATTGT
CGAAGCTCTCG -> GAAGCTCTCGG
CGACCAAAAGT -> GACCAAAAGTG
CGACCCGTACC -> GACCCGTACCC
CGACCTGCTCC -> GACCTGCTCCA
CGACGCAATAG -> GACGCAATAGT
CGACTATCACC -> GACTATCACCA
CGACTTGTTGA -> GACTTGTTGAT
CGAGACGTAGT -> GAGACGTAGTG
CGAGACTAATC -> GAGACTAATCG
CGAGACTTTTC -> GAGACTTTTCA
CGAGCCCGAAA -> GAGCCCGAAAA
CGAGGAGCTTG -> GAGGAGCTTGT
CGAGGGACACA -> GAGGGACACAA
CGAGTCATAGG -> GAGTCATAGGG
CGAGTCGCCGA -> GAGTCGCCGAG
CGATATAACCT -> GATATAACCTA
CGATCACCGGC -> GATCACCGGCT
CGATTCAAAGT -> GATTCAAAGTT
CGCAATAGTCT -> GCAATAGTCTA
CGCAGAGCACA -> GCAGAGCACAC
CGCATAGCCAA -> GCATAGCCAAG
CGCATCGGTGA -> GCATCGGTGAC
CGCCAAATGTC -> GCCAAATGTCT
CGCCCACGAAC -> GCCCACGAACT
CGCCCGGTATA -> GCCCGGTATAA
CGCCGAAGCTC -> GCCGAAGCTCT
CGCCGACGCAA -> GCCGACGCAAT
CGCCGAGCCCG -> GCCGAGCCCGA
CGCCGCCGACG -> GCCGCCGACGC
CGCCTAGTGCA -> GCCTAGTGCAC
CGCCTCACGAA -> GCCTCACGAAC
CGCCTGGTAAC -> GCCTGGTAACA
CGCGACCCGTA -> GCGACCCGTAC
CGCGAGGGACA -> GCGAGGGACAC
CGCGCGCGGCG -> GCGCGCGGCGT
CGCGCGGCGTA -> GCGCGGCGTAA
CGCGGCGTAAT -> GCGGCGTAATT
CGCGTGAGCGG -> GCGTGAGCGGA
CGCGTGGGACT -> GCGTGGGACTG
CGCTTGCTAAA -> GCTTGCTAAAA
CGCTTTAAAAA -> GCTTTAAAAAA
CGCTTTTTCAC -> GCTTTTTCACT
CGGAATATACA -> GGAATATACAT
CGGAGGGCCCT -> GGAGGGCCCTG
CGGATCTCCAC -> GGATCTCCACT
CGGATGCTACG -> GGATGCTACGG
CGGATTCATAA -> GGATTCATAAC
CGGCAAGTTAA -> GGCAAGTTAAT
CGGCCTCGTGA -> GGCCTCGTGAT
CGGCGGCCTCG -> GGCGGCCTCGT
CGGCGTAATTG -> GGCGTAATTGC
CGGCTAGATCC -> GGCTAGATCCC
CGGCTCGAACG -> GGCTCGAACGT
CGGCTTAAGAA -> GGCTTAAGAAT
CGGCTTAATAA -> GGCTTAATAAA
CGGGACGCGAG -> GGGACGCGAGG
CGGGATACGTC -> GGGATACGTCC
CGGGTATTCCA -> GGGTATTCCAG
CGGGTGATGTC -> GGGTGATGTCT
CGGTATAAGAC -> GGTATAAGACA
CGGTGACGCGT -> GGTGACGCGTG
CGGTGAGTTGA -> GGTGAGTTGAG
CGGTGTCAAGT -> GGTGTCAAGTA
CGGTGTCTTGT -> GGTGTCTTGTC
CGGTTCATGGT -> GGTTCATGGTT
CGGTTCCTTGG -> GGTTCCTTGGG
CGTAACTTCAA -> GTAACTTCAAC
CGTAATTGCCG -> GTAATTGCCGC
CGTACCCTATA -> GTACCCTATAT
CGTACTGCCGA -> GTACTGCCGAG
CGTACTTGAAA -> GTACTTGAAAG
CGTAGACCAAG -> GTAGACCAAGG
CGTAGCTTAAC -> GTAGCTTAACT
CGTAGGGTATA -> GTAGGGTATAG
CGTAGTGTCCC -> GTAGTGTCCCA
CGTCCCGAGGA -> GTCCCGAGGAG
CGTCCGCCCAC -> GTCCGCCCACG
CGTCGCTTTAA -> GTCGCTTTAAA
CGTCTAAGCAT -> GTCTAAGCATA
CGTGACTTGAT -> GTGACTTGATT
CGTGAGCGGAT -> GTGAGCGGATC
CGTGATGGGCC -> GTGATGGGCCT
CGTGATTCGGA -> GTGATTCGGAA
CGTGATTCTCG -> GTGATTCTCGT
CGTGGGACTGA -> GTGGGACTGAT
CGTGGGCTTAA -> GTGGGCTTAAC
CGTGGGCTTGG -> GTGGGCTTGGG
CGTGGGTGGCG -> GTGGGTGGCGG
CGTTTTGAGTC -> GTTTTGAGTCA
CGTTTTTCCCC -> GTTTTTCCCCT
CTAAAAACCGA -> TAAAAACCGAG
CTAAAAGCGTG -> TAAAAGCGTGA
CTAACGGAGGG -> TAACGGAGGGC
CTAAGCATACT -> TAAGCATACTG
CTAAGTTTTGG -> TAAGTTTTGGT
CTAATACATTG -> TAATACATTGG
CTAATCATCCG -> TAATCATCCGA
CTAATCGGGTG -> TAATCGGGTGA
CTAATTATGAG -> TAATTATGAGA
CTACCAAAACT -> TACCAAAACTC
CTACGGCGGCC -> TACGGCGGCCT
CTACGTCGCTT -> TACGTCGCTTT
CTACTCCCCGC -> TACTCCCCGCT
CTACTCGTTTT -> TACTCGTTTTG
CTAGAACATGA -> TAGAACATGAA
CTAGAGATTAA -> TAGAGATTAAC
CTAGATCCCTT -> TAGATCCCTTG
CTAGCACGATC -> TAGCACGATCA
CTAGTGCACCC -> TAGTGCACCCT
CTATAGATGAC -> TATAGATGACT
CTATAGATGCA -> TATAGATGCAT
CTATATAAATC -> TATATAAATCA
CTATCACCAAC -> TATCACCAACT
CTATCATCCCT -> TATCATCCCTC
CTATCGCATCG -> TATCGCATCGG
CTATCGGGACG -> TATCGGGACGC
CTATTGCCAAG -> TATTGCCAAGA
CTATTGCTCAT -> TATTGCTCATT
CTATTGGTTCA -> TATTGGTTCAT
CTCAAAACCAC -> TCAAAACCACT
CTCAAGATGGC -> TCAAGATGGCC
CTCACCGGGTA -> TCACCGGGTAT
CTCACCTCCAT -> TCACCTCCATA
CTCACGAACGC -> TCACGAACGCC
CTCAGCCCCGC -> TCAGCCCCGCC,TCAGCCCCGCG
CTCATCGACTA -> TCATCGACTAT
CTCATTCATAG -> TCATTCATAGT
CTCCACTCAGC -> TCCACTCAGCC
CTCCATACGTC -> TCCATACGTCT
CTCCATAGCAC -> TCCATAGCACA
CTCCATTCACC -> TCCATTCACCA
CTCCCCGCTTG -> TCCCCGCTTGC
CTCCGGTGTCT -> TCCGGTGTCTT
CTCCGTGGGCT -> TCCGTGGGCTT
CTCGAACGTAA -> TCGAACGTAAC
CTCGGCAAGTT -> TCGGCAAGTTA
CTCGGCTAGAT -> TCGGCTAGATC
CTCGGCTCGAA -> TCGGCTCGAAC
CTCGTGATTCT -> TCGTGATTCTC
CTCGTTTTGAG -> TCGTTTTGAGT
CTCGTTTTTCC -> TCGTTTTTCCC
CTCTCACCTCC -> TCTCACCTCCA
CTCTCAGCCCC -> TCTCAGCCCCG
CTCTCGGCTAG -> TCTCGGCTAGA
CTCTCTCAGCC -> TCTCTCAGCCC
CTCTGGCGCGC -> TCTGGCGCGCG
CTCTTATGCTG -> TCTTATGCTGG
CTGACATCCTC -> TGACATCCTCA
CTGATGCCCAC -> TGATGCCCACC
CTGATTCCTAT -> TGATTCCTATC
CTGCACTCCGG -> TGCACTCCGGT
CTGCCAGCCGC -> TGCCAGCCGCC
CTGCCGAGTCG -> TGCCGAGTCGC
CTGCCTCGGCA -> TGCCTCGGCAA
CTGCCTCTTAT -> TGCCTCTTATG
CTGCGGTGAGT -> TGCGGTGAGTT
CTGCTCCATAG -> TGCTCCATAGC
CTGCTTACCAA -> TGCTTACCAAT
CTGGCATGACC -> TGGCATGACCG
CTGGCCCCCGG -> TGGCCCCCGGA
CTGGCGCGCGC -> TGGCGCGCGCG
CTGGCGGCCGT -> TGGCGGCCGTT
CTGGTAACACC -> TGGTAACACCC
CTGGTCGTGGG -> TGGTCGTGGGT
CTGGTCTAGAG -> TGGTCTAGAGA
CTTAACGTAGG -> TTAACGTAGGG
CTTAACTATCG -> TTAACTATCGG
CTTAAGAATGG -> TTAAGAATGGA
CTTAATAAATT -> TTAATAAATTT
CTTACCAATAA -> TTACCAATAAG
CTTACCTTGCA -> TTACCTTGCAA
CTTAGCAAACA -> TTAGCAAACAT
CTTAGGCAGCG -> TTAGGCAGCGC
CTTAGTTAGCT -> TTAGTTAGCTA
CTTATCACGGC -> TTATCACGGCT
CTTATGCTGGT -> TTATGCTGGTC
CTTATTGTAGT -> TTATTGTAGTG
CTTATTTGGGT -> TTATTTGGGTA
CTTCAACACAG -> TTCAACACAGG
CTTCCAGACCG -> TTCCAGACCGT
CTTCTAAAAAC -> TTCTAAAAACC
CTTCTTCTTGA -> TTCTTCTTGAC
CTTCTTGACTT -> TTCTTGACTTT
CTTGAAAGCGA -> TTGAAAGCGAT
CTTGAAGTTCG -> TTGAAGTTCGC
CTTGACTTTGC -> TTGACTTTGCC
CTTGATAAGGA -> TTGATAAGGAC
CTTGATTGATA -> TTGATTGATAC
CTTGCAATTAG -> TTGCAATTAGA
CTTGCTAAAAG -> TTGCTAAAAGC
CTTGGGCCTTA -> TTGGGCCTTAT
CTTGGGGGAGG -> TTGGGGGAGGA
CTTGTAGATGA -> TTGTAGATGAA
CTTGTATTACA -> TTGTATTACAC
CTTGTCGCCCG -> TTGTCGCCCGG
CTTGTCGGTGT -> TTGTCGGTGTC
CTTGTGACGTA -> TTGTGACGTAC
CTTGTTGATCG -> TTGTTGATCGC
CTTTAAAAAAC -> TTTAAAAAACG
CTTTCAGGAAT -> TTTCAGGAATG
CTTTCGTCCGC -> TTTCGTCCGCC
CTTTGCCTAGA -> TTTGCCTAGAA
CTTTGGTCTAC -> TTTGGTCTACT
CTTTGTGTAAC -> TTTGTGTAACG
CTTTTCAGTCC -> TTTTCAGTCCG
CTTTTTCACTA -> TTTTTCACTAT
GAAAAAGTTAG -> AAAAAGTTAGC
GAAAAGGTGAG -> AAAAGGTGAGA
GAAACTTGTAT -> AAACTTGTATT
GAAAGCGATAT -> AAAGCGATATA
GAAAGGTGGCA -> AAAGGTGGCAC
GAACATGAACT -> AACATGAACTC
GAACGCCAAAT -> AACGCCAAATG
GAACGTAACTT -> AACGTAACTTC
GAACTATCGCA -> AACTATCGCAT
GAACTCAAAAC -> AACTCAAAACC
GAACTGGCGGC -> AACTGGCGGCC
GAACTTATTGT -> AACTTATTGTA
GAAGAAAAGGT -> AAGAAAAGGTG
GAAGCAGGGTT -> AAGCAGGGTTT
GAAGCTCTCGG -> AAGCTCTCGGC
GAAGCTTCTAA -> AAGCTTCTAAA
GAAGGGCCAGT -> AAGGGCCAGTC
GAAGGTAACGT -> AAGGTAACGTA
GAAGTTCGCTT -> AAGTTCGCTTT
GAATATACATT -> AATATACATTC
GAATGCATAGT -> AATGCATAGTG
GAATGGAGGTC -> AATGGAGGTCT
GACAACTGGCA -> ACAACTGGCAT
GACACAAGTTT -> ACACAAGTTTA
GACAGGCTATA -> ACAGGCTATAG
GACATCCTCAC -> ACATCCTCACC
GACATTCTAAC -> ACATTCTAACG
GACCAAAAGTG -> ACCAAAAGTGC
GACCAAGGAGG -> ACCAAGGAGGA
GACCCGTACCC -> ACCCGTACCCT
GACCGACCTGC -> ACCGACCTGCT
GACCGTACTGC -> ACCGTACTGCC
GACCGTGGGCT -> ACCGTGGGCTT
GACCTGCTCCA -> ACCTGCTCCAT
GACGCAATAGT -> ACGCAATAGTC
GACGCGAGGGA -> ACGCGAGGGAC
GACGCGTGGGA -> ACGCGTGGGAC
GACGTACTTGA -> ACGTACTTGAA
GACGTAGCTTA -> ACGTAGCTTAA
GACGTAGTGTC -> ACGTAGTGTCC
GACTAATCATC -> ACTAATCATCC
GACTAATCGGG -> ACTAATCGGGT
GACTATAGATG -> ACTATAGATGA
GACTATCACCA -> ACTATCACCAA
GACTCGGCTCG -> ACTCGGCTCGA
GACTGATTCCT -> ACTGATTCCTA
GACTTGATTGA -> ACTTGATTGAT
GACTTGTTGAT -> ACTTGTTGATC
GACTTTGCCTA -> ACTTTGCCTAG
GACTTTGTGTA -> ACTTTGTGTAA
GACTTTTCAGT -> ACTTTTCAGTC
GAGAAACTTGT -> AGAAACTTGTA
GAGAAAGGTGG -> AGAAAGGTGGC
GAGACAACTGG -> AGACAACTGGC
GAGACGTAGTG -> AGACGTAGTGT
GAGACTAATCG -> AGACTAATCGG
GAGACTTTTCA -> AGACTTTTCAG
GAGATTAACTT -> AGATTAACTTA
GAGATTTACCA -> AGATTTACCAC
GAGCACACCCC -> AGCACACCCCG
GAGCCCGAAAA -> AGCCCGAAAAA
GAGCGGATCTC -> AGCGGATCTCC
GAGCTTGTCGC -> AGCTTGTCGCC
GAGGAGCTTGT -> AGGAGCTTGTC
GAGGAGTGTTT -> AGGAGTGTTTG
GAGGATTTCTG -> AGGATTTCTGA
GAGGGACACAA -> AGGGACACAAG
GAGGGACGTAG -> AGGGACGTAGC
GAGGGCCCTGA -> AGGGCCCTGAT
GAGGTCTGCCA -> AGGTCTGCCAG
GAGTCAGTTAT -> AGTCAGTTATT
GAGTCATAGGG -> AGTCATAGGGC
GAGTCGCCGAG -> AGTCGCCGAGC
GAGTGTGGACA -> AGTGTGGACAT
GAGTGTTTGCA -> AGTGTTTGCAT
GAGTTGAGACA -> AGTTGAGACAA
GATAAGGACTC -> ATAAGGACTCG
GATACCATCAT -> ATACCATCATA
GATACGTCCCG -> ATACGTCCCGA
GATATAACCTA -> ATATAACCTAT
GATATTACCTT -> ATATTACCTTC
GATCACCGGCT -> ATCACCGGCTT
GATCCCTTGAT -> ATCCCTTGATA
GATCGCCTGGT -> ATCGCCTGGTA
GATCTCCACTC -> ATCTCCACTCA
GATGAAGGTAA -> ATGAAGGTAAC
GATGACTAATC -> ATGACTAATCA
GATGCATATGA -> ATGCATATGAG
GATGCCCACCT -> ATGCCCACCTT
GATGCTACGGC -> ATGCTACGGCG
GATGGCCCGGT -> ATGGCCCGGTT
GATGGGCCTTT -> ATGGGCCTTTC
GATGTCTTCCA -> ATGTCTTCCAG
GATGTGGGGAT -> ATGTGGGGATG
GATGTTCCCAA -> ATGTTCCCAAC
GATTAACTTAG -> ATTAACTTAGT
GATTCAAAGTT -> ATTCAAAGTTT
GATTCACCCCC -> ATTCACCCCCG
GATTCATAACT -> ATTCATAACTA
GATTCCTATCA -> ATTCCTATCAT
GATTCGGAATA -> ATTCGGAATAT
GATTCTCGTTT -> ATTCTCGTTTT
GATTGATACCA -> ATTGATACCAT
GATTTACCACG -> ATTTACCACGC
GATTTCTGACA -> ATTTCTGACAT
GCAAACATCAG -> CAAACATCAGT
GCAAGTTAATA -> CAAGTTAATAC
GCAATAGTCTA -> CAATAGTCTAC
GCAATTAGACT -> CAATTAGACTA
GCACAAAGTCC -> CACAAAGTCCT
GCACACCCCGA -> CACACCCCGAC
GCACAGGGATA -> CACAGGGATAT
GCACCCTTGAA -> CACCCTTGAAG
GCACGATCACC -> CACGATCACCG
GCACTCCGGTG -> CACTCCGGTGT
GCACTTACCTT -> CACTTACCTTG
GCACTTAGGCA -> CACTTAGGCAG
GCAGAACTGGC -> CAGAACTGGCG
GCAGAGCACAC -> CAGAGCACACC
GCAGCGCCTCA -> CAGCGCCTCAC
GCAGGGTTTTA -> CAGGGTTTTAC
GCATACTGGTC -> CATACTGGTCG
GCATAGCCAAG -> CATAGCCAAGT
GCATAGTGACT -> CATAGTGACTT
GCATATGAGTG -> CATATGAGTGT
GCATATGCACT -> CATATGCACTT
GCATCGGTGAC -> CATCGGTGACG
GCATCTGGCCC -> CATCTGGCCCC
GCATGACCGTA -> CATGACCGTAC
GCCAAATGTCT -> CCAAATGTCTC
GCCAAGAAGAA -> CCAAGAAGAAA
GCCAAGTACTA -> CCAAGTACTAA
GCCAGCCGCCT -> CCAGCCGCCTA
GCCAGTCTTAT -> CCAGTCTTATT
GCCCACCTTTG -> CCCACCTTTGG
GCCCACGAACT -> CCCACGAACTT
GCCCCCGGATG -> CCCCCGGATGC
GCCCCGCCGCC -> CCCCGCCGCCG
GCCCCGCGTGA -> CCCCGCGTGAG
GCCCGAAAAAG -> CCCGAAAAAGT
GCCCGAACTAT -> CCCGAACTATC
GCCCGGTATAA -> CCCGGTATAAG
GCCCGGTTCCT -> CCCGGTTCCTT
GCCCTCTGGCG -> CCCTCTGGCGC
GCCCTGATGCC -> CCCTGATGCCC
GCCGAAGCTCT -> CCGAAGCTCTC
GCCGACGCAAT -> CCGACGCAATA
GCCGAGACTTT -> CCGAGACTTTT
GCCGAGCCCGA -> CCGAGCCCGAA
GCCGAGTCGCC -> CCGAGTCGCCG
GCCGCCGAAGC -> CCGCCGAAGCT
GCCGCCGACGC -> CCGCCGACGCA
GCCGCCTAGTG -> CCGCCTAGTGC
GCCGGATTCAT -> CCGGATTCATA
GCCTAGAACAT -> CCTAGAACATG
GCCTAGTGCAC -> CCTAGTGCACC
GCCTCACGAAC -> CCTCACGAACG
GCCTCGGCAAG -> CCTCGGCAAGT
GCCTCGTGATT -> CCTCGTGATTC
GCCTCTTATGC -> CCTCTTATGCT
GCCTGGTAACA -> CCTGGTAACAC
GCCTTATCACG -> CCTTATCACGG
GCCTTTCAGGA -> CCTTTCAGGAA
GCGACCCGTAC -> CGACCCGTACC
GCGAGGGACAC -> CGAGGGACACA
GCGATATAACC -> CGATATAACCT
GCGATTCAAAG -> CGATTCAAAGT
GCGCCTCACGA -> CGCCTCACGAA
GCGCGCGCGGC -> CGCGCGCGGCG
GCGCGCGGCGT -> CGCGCGGCGTA
GCGCGGCGTAA -> CGCGGCGTAAT
GCGGATCTCCA -> CGGATCTCCAC
GCGGCCTCGTG -> CGGCCTCGTGA
GCGGCGTAATT -> CGGCGTAATTG
GCGGGATACGT -> CGGGATACGTC
GCGGTGAGTTG -> CGGTGAGTTGA
GCGTAATTGCC -> CGTAATTGCCG
GCGTGACTTGA -> CGTGACTTGAT
GCGTGAGCGGA -> CGTGAGCGGAT
GCGTGGGACTG -> CGTGGGACTGA
GCTAAAAGCGT -> CTAAAAGCGTG
GCTACGGCGGC -> CTACGGCGGCC
GCTAGATCCCT -> CTAGATCCCTT
GCTAGCACGAT -> CTAGCACGATC
GCTATAGATGC -> CTATAGATGCA
GCTCATTCATA -> CTCATTCATAG
GCTCCATAGCA -> CTCCATAGCAC
GCTCGAACGTA -> CTCGAACGTAA
GCTCTCGGCTA -> CTCTCGGCTAG
GCTGCACTCCG -> CTGCACTCCGG
GCTGGTCTAGA -> CTGGTCTAGAG
GCTTAACGTAG -> CTTAACGTAGG
GCTTAACTATC -> CTTAACTATCG
GCTTAAGAATG -> CTTAAGAATGG
GCTTAATAAAT -> CTTAATAAATT
GCTTACCAATA -> CTTACCAATAA
GCTTCTAAAAA -> CTTCTAAAAAC
GCTTGCTAAAA -> CTTGCTAAAAG
GCTTGGGCCTT -> CTTGGGCCTTA
GCTTGTCGCCC -> CTTGTCGCCCG
GCTTTAAAAAA -> CTTTAAAAAAC
GCTTTTTCACT -> CTTTTTCACTA
GGAATATACAT -> GAATATACATT
GGAATGCATAG -> GAATGCATAGT
GGACACAAGTT -> GACACAAGTTT
GGACATTCTAA -> GACATTCTAAC
GGACGCGAGGG -> GACGCGAGGGA
GGACGTAGCTT -> GACGTAGCTTA
GGACTCGGCTC -> GACTCGGCTCG
GGACTGATTCC -> GACTGATTCCT
GGAGATTTACC -> GAGATTTACCA
GGAGCTTGTCG -> GAGCTTGTCGC
GGAGGAGTGTT -> GAGGAGTGTTT
GGAGGATTTCT -> GAGGATTTCTG
GGAGGGACGTA -> GAGGGACGTAG
GGAGGGCCCTG -> GAGGGCCCTGA
GGAGGTCTGCC -> GAGGTCTGCCA
GGAGTGTTTGC -> GAGTGTTTGCA
GGATACGTCCC -> GATACGTCCCG
GGATATTACCT -> GATATTACCTT
GGATCTCCACT -> GATCTCCACTC
GGATGCTACGG -> GATGCTACGGC
GGATGTTCCCA -> GATGTTCCCAA
GGATTCATAAC -> GATTCATAACT
GGATTTCTGAC -> GATTTCTGACA
GGCAAGTTAAT -> GCAAGTTAATA
GGCACTTAGGC -> GCACTTAGGCA
GGCAGCGCCTC -> GCAGCGCCTCA
GGCATCTGGCC -> GCATCTGGCCC
GGCATGACCGT -> GCATGACCGTA
GGCCAGTCTTA -> GCCAGTCTTAT
GGCCCCCGGAT -> GCCCCCGGATG
GGCCCGGTTCC -> GCCCGGTTCCT
GGCCCTGATGC -> GCCCTGATGCC
GGCCGAGACTT -> GCCGAGACTTT
GGCCGGATTCA -> GCCGGATTCAT
GGCCTCGTGAT -> GCCTCGTGATT
GGCCTTATCAC -> GCCTTATCACG
GGCCTTTCAGG -> GCCTTTCAGGA
GGCGCGCGCGG -> GCGCGCGCGGC
GGCGGCCGTTT -> GCGGCCGTTTC
GGCGGCCTCGT -> GCGGCCTCGTG
GGCGGGATACG -> GCGGGATACGT
GGCGTAATTGC -> GCGTAATTGCC
GGCTAGATCCC -> GCTAGATCCCT
GGCTATAGATG -> GCTATAGATGC
GGCTCGAACGT -> GCTCGAACGTA
GGCTTAACGTA -> GCTTAACGTAG
GGCTTAAGAAT -> GCTTAAGAATG
GGCTTAATAAA -> GCTTAATAAAT
GGCTTGGGCCT -> GCTTGGGCCTT
GGGACACAAGT -> GGACACAAGTT
GGGACGCGAGG -> GGACGCGAGGG
GGGACGTAGCT -> GGACGTAGCTT
GGGACTGATTC -> GGACTGATTCC
GGGAGGAGTGT -> GGAGGAGTGTT
GGGATACGTCC -> GGATACGTCCC
GGGATATTACC -> GGATATTACCT
GGGATGTTCCC -> GGATGTTCCCA
GGGCATCTGGC -> GGCATCTGGCC
GGGCCAGTCTT -> GGCCAGTCTTA
GGGCCCTGATG -> GGCCCTGATGC
GGGCCTTATCA -> GGCCTTATCAC
GGGCCTTTCAG -> GGCCTTTCAGG
GGGCTTAACGT -> GGCTTAACGTA
GGGCTTGGGCC -> GGCTTGGGCCT
GGGGAGGAGTG -> GGGAGGAGTGT
GGGGATGTTCC -> GGGATGTTCCC
GGGGGAGGAGT -> GGGGAGGAGTG
GGGTACATCAT -> GGTACATCATG
GGGTATAGGTA -> GGTATAGGTAC
GGGTATTCCAG -> GGTATTCCAGA
GGGTGATGTCT -> GGTGATGTCTT
GGGTGGCGGGA -> GGTGGCGGGAT
GGGTTTTACTC -> GGTTTTACTCA
GGTAACACCCG -> GTAACACCCGT
GGTAACGTAGA -> GTAACGTAGAC
GGTACATCATG -> GTACATCATGT
GGTACGCAGAG -> GTACGCAGAGC
GGTATAAGACA -> GTATAAGACAG
GGTATAGGTAC -> GTATAGGTACG
GGTATTCCAGA -> GTATTCCAGAT
GGTCCCATCTG -> GTCCCATCTGC
GGTCGTGGGTG -> GTCGTGGGTGG
GGTCTACTCGT -> GTCTACTCGTT
GGTCTAGAGAT -> GTCTAGAGATT
GGTCTCCGTGG -> GTCTCCGTGGG
GGTCTGCCAGC -> GTCTGCCAGCC
GGTCTGCCTCG -> GTCTGCCTCGG
GGTGACGCGTG -> GTGACGCGTGG
GGTGAGAAAGG -> GTGAGAAAGGT
GGTGAGTTGAG -> GTGAGTTGAGA
GGTGATGTCTT -> GTGATGTCTTC
GGTGGCACTTA -> GTGGCACTTAG
GGTGGCGGGAT -> GTGGCGGGATA
GGTGTCAAGTA -> GTGTCAAGTAT
GGTGTCTTGTC -> GTGTCTTGTCG
GGTGTGGTCTG -> GTGTGGTCTGC
GGTGTGTATAG -> GTGTGTATAGG
GGTTCATACTT -> GTTCATACTTA
GGTTCATGGTT -> GTTCATGGTTG
GGTTCCTTGGG -> GTTCCTTGGGG
GGTTGGAGGGA -> GTTGGAGGGAC
GGTTGTATTGC -> GTTGTATTGCG
GGTTTTACTCA -> GTTTTACTCAA
GTAACACCCGT -> TAACACCCGTG
GTAACGCGACC -> TAACGCGACCC
GTAACGTAGAC -> TAACGTAGACC
GTAACTTCAAC -> TAACTTCAACA
GTAATTGCCGC -> TAATTGCCGCC
GTACAGGTGTG -> TACAGGTGTGT
GTACATCATGT -> TACATCATGTA
GTACCCTATAT -> TACCCTATATA
GTACGCAGAGC -> TACGCAGAGCA
GTACTAATACA -> TACTAATACAT
GTACTGCCGAG -> TACTGCCGAGT
GTACTTGAAAG -> TACTTGAAAGC
GTAGACCAAGG -> TAGACCAAGGA
GTAGATGAAGG -> TAGATGAAGGT
GTAGCTTAACT -> TAGCTTAACTA
GTAGGGTATAG -> TAGGGTATAGG
GTAGTGGCCGA -> TAGTGGCCGAG
GTAGTGTCCCA -> TAGTGTCCCAT
GTATAAGACAG -> TATAAGACAGG
GTATACTAAGT -> TATACTAAGTT
GTATAGGTACG -> TATAGGTACGC
GTATAGGTCTC -> TATAGGTCTCC
GTATATTTAAC -> TATATTTAACT
GTATGACCGAC -> TATGACCGACC
GTATTACACTA -> TATTACACTAC
GTATTCCAGAT -> TATTCCAGATT
GTATTCGGTTC -> TATTCGGTTCA
GTATTGCGATT -> TATTGCGATTC
GTCAAGTATAT -> TCAAGTATATT
GTCAGTTATTG -> TCAGTTATTGC
GTCATAGGGCA -> TCATAGGGCAT
GTCCCATCTGC -> TCCCATCTGCG
GTCCCATTGTA -> TCCCATTGTAC
GTCCCGAGGAG -> TCCCGAGGAGC
GTCCGACTTGT -> TCCGACTTGTT
GTCCGCCCACG -> TCCGCCCACGA
GTCCTTGTGAC -> TCCTTGTGACG
GTCGCCCGGTA -> TCGCCCGGTAT
GTCGCCGAGCC -> TCGCCGAGCCC
GTCGCTTTAAA -> TCGCTTTAAAA
GTCGGTGTCAA -> TCGGTGTCAAG
GTCGTGGGTGG -> TCGTGGGTGGC
GTCTAAGCATA -> TCTAAGCATAC
GTCTACGTCGC -> TCTACGTCGCT
GTCTACTCGTT -> TCTACTCGTTT
GTCTAGAGATT -> TCTAGAGATTA
GTCTCCATTCA -> TCTCCATTCAC
GTCTCCGTGGG -> TCTCCGTGGGC
GTCTGCCAGCC -> TCTGCCAGCCG
GTCTGCCTCGG -> TCTGCCTCGGC
GTCTTATTTGG -> TCTTATTTGGG
GTCTTCCAGAC -> TCTTCCAGACC
GTCTTGTCGGT -> TCTTGTCGGTG
GTGACGCGTGG -> TGACGCGTGGG
GTGACGTACTT -> TGACGTACTTG
GTGACTTGATT -> TGACTTGATTG
GTGACTTTGTG -> TGACTTTGTGT
GTGAGAAAGGT -> TGAGAAAGGTG
GTGAGCGGATC -> TGAGCGGATCT
GTGAGTTGAGA -> TGAGTTGAGAC
GTGATGGGCCT -> TGATGGGCCTT
GTGATGTCTTC -> TGATGTCTTCC
GTGATTCGGAA -> TGATTCGGAAT
GTGATTCTCGT -> TGATTCTCGTT
GTGCACCCTTG -> TGCACCCTTGA
GTGCCCGAACT -> TGCCCGAACTA
GTGGACATTCT -> TGGACATTCTA
GTGGCACTTAG -> TGGCACTTAGG
GTGGCCGAGAC -> TGGCCGAGACT
GTGGCGGGATA -> TGGCGGGATAC
GTGGGACTGAT -> TGGGACTGATT
GTGGGCTTAAC -> TGGGCTTAACG
GTGGGCTTGGG -> TGGGCTTGGGC
GTGGGGATGTT -> TGGGGATGTTC
GTGGGTGGCGG -> TGGGTGGCGGG
GTGGTCTGCCT -> TGGTCTGCCTC
GTGTAACGCGA -> TGTAACGCGAC
GTGTATAGGTC -> TGTATAGGTCT
GTGTCAAGTAT -> TGTCAAGTATA
GTGTCCCATTG -> TGTCCCATTGT
GTGTCTTGTCG -> TGTCTTGTCGG
GTGTGGACATT -> TGTGGACATTC
GTGTGGTCTGC -> TGTGGTCTGCC
GTGTGTATAGG -> TGTGTATAGGT
GTGTTTGCATA -> TGTTTGCATAT
GTTAATACTAC -> TTAATACTACC
GTTAGCAGAAC -> TTAGCAGAACT
GTTAGCTAGCA -> TTAGCTAGCAC
GTTATTGCCCT -> TTATTGCCCTC
GTTCATACTTA -> TTCATACTTAG
GTTCATGGTTG -> TTCATGGTTGG
GTTCCCAACAC -> TTCCCAACACT
GTTCCTTGGGG -> TTCCTTGGGGG
GTTCGCTTTTT -> TTCGCTTTTTC
GTTGAGACAAC -> TTGAGACAACT
GTTGATCGCCT -> TTGATCGCCTG
GTTGCTGCACT -> TTGCTGCACTC
GTTGGAGGGAC -> TTGGAGGGACG
GTTGTATTGCG -> TTGTATTGCGA
GTTTAAACCCA -> TTTAAACCCAT
GTTTAGCACAG -> TTTAGCACAGG
GTTTGCATATG -> TTTGCATATGC
GTTTTACTCAA -> TTTTACTCAAG
GTTTTGAGTCA -> TTTTGAGTCAG
GTTTTGGTTGT -> TTTTGGTTGTA
GTTTTTCCCCT -> TTTTTCCCCTT
TAAAAAACGAG -> AAAAAACGAGA
TAAAAACCGAG -> AAAAACCGAGA
TAAAAGCGTGA -> AAAAGCGTGAC
TAAACCCATGA -> AAACCCATGAT
TAAATCAGTAT -> AAATCAGTATA
TAAATTTGGTC -> AAATTTGGTCC
TAACACCCGTG -> AACACCCGTGA
TAACCTATTGC -> AACCTATTGCT
TAACGCGACCC -> AACGCGACCCG
TAACGGAGGGC -> AACGGAGGGCC
TAACGTAGACC -> AACGTAGACCA
TAACGTAGGGT -> AACGTAGGGTA
TAACTAATTAT -> AACTAATTATG
TAACTATCGGG -> AACTATCGGGA
TAACTCTCACC -> AACTCTCACCT
TAACTTAGTTA -> AACTTAGTTAG
TAACTTCAACA -> AACTTCAACAC
TAAGAAGGGCC -> AAGAAGGGCCA
TAAGAATGGAG -> AAGAATGGAGG
TAAGACAGGCT -> AAGACAGGCTA
TAAGCATACTG -> AAGCATACTGG
TAAGGACTCGG -> AAGGACTCGGC
TAAGTTTTGGT -> AAGTTTTGGTT
TAATAAATTTG -> AATAAATTTGG
TAATACATTGG -> AATACATTGGT
TAATACTACCA -> AATACTACCAA
TAATCATCCGA -> AATCATCCGAG
TAATCGGGTGA -> AATCGGGTGAT
TAATTATGAGA -> AATTATGAGAA
TAATTGCCGCC -> AATTGCCGCCG
TACACCTTTCG -> ACACCTTTCGT
TACACTACTCC -> ACACTACTCCC
TACAGGTGTGT -> ACAGGTGTGTA
TACATCATGTA -> ACATCATGTAT
TACATTCAGAA -> ACATTCAGAAG
TACATTGGTGT -> ACATTGGTGTG
TACCAAAACTC -> ACCAAAACTCT
TACCAATAAGA -> ACCAATAAGAA
TACCACGCATA -> ACCACGCATAG
TACCATCATAC -> ACCATCATACA
TACCCTATATA -> ACCCTATATAA
TACCTTCTTCT -> ACCTTCTTCTT
TACCTTGCAAT -> ACCTTGCAATT
TACGCAGAGCA -> ACGCAGAGCAC
TACGGCGGCCT -> ACGGCGGCCTC
TACGTCCCGAG -> ACGTCCCGAGG
TACGTCGCTTT -> ACGTCGCTTTA
TACGTCTAAGC -> ACGTCTAAGCA
TACTAAGTTTT -> ACTAAGTTTTG
TACTAATACAT -> ACTAATACATT
TACTACCAAAA -> ACTACCAAAAC
TACTCAAGATG -> ACTCAAGATGG
TACTCCCCGCT -> ACTCCCCGCTT
TACTCGTTTTG -> ACTCGTTTTGA
TACTGCCGAGT -> ACTGCCGAGTC
TACTGGTCGTG -> ACTGGTCGTGG
TACTTAGCAAA -> ACTTAGCAAAC
TACTTGAAAGC -> ACTTGAAAGCG
TAGAACATGAA -> AGAACATGAAC
TAGACCAAGGA -> AGACCAAGGAG
TAGACTATAGA -> AGACTATAGAT
TAGAGATTAAC -> AGAGATTAACT
TAGATCCCTTG -> AGATCCCTTGA
TAGATGAAGGT -> AGATGAAGGTA
TAGATGACTAA -> AGATGACTAAT
TAGATGCATAT -> AGATGCATATG
TAGCAAACATC -> AGCAAACATCA
TAGCACAAAGT -> AGCACAAAGTC
TAGCACAGGGA -> AGCACAGGGAT
TAGCACGATCA -> AGCACGATCAC
TAGCAGAACTG -> AGCAGAACTGG
TAGCCAAGTAC -> AGCCAAGTACT
TAGCTAGCACG -> AGCTAGCACGA
TAGCTTAACTA -> AGCTTAACTAT
TAGGAGATTTA -> AGGAGATTTAC
TAGGCAGCGCC -> AGGCAGCGCCT
TAGGGCATCTG -> AGGGCATCTGG
TAGGGTATAGG -> AGGGTATAGGT
TAGGTACGCAG -> AGGTACGCAGA
TAGGTCTCCGT -> AGGTCTCCGTG
TAGTCTACGTC -> AGTCTACGTCG
TAGTGACTTTG -> AGTGACTTTGT
TAGTGCACCCT -> AGTGCACCCTT
TAGTGGCCGAG -> AGTGGCCGAGA
TAGTGTCCCAT -> AGTGTCCCATT
TAGTTAGCTAG -> AGTTAGCTAGC
TAGTTGCTGCA -> AGTTGCTGCAC
TATAAATCAGT -> ATAAATCAGTA
TATAACCTATT -> ATAACCTATTG
TATAAGACAGG -> ATAAGACAGGC
TATACATTCAG -> ATACATTCAGA
TATACTAAGTT -> ATACTAAGTTT
TATAGATGACT -> ATAGATGACTA
TATAGATGCAT -> ATAGATGCATA
TATAGGAGATT -> ATAGGAGATTT
TATAGGTACGC -> ATAGGTACGCA
TATAGGTCTCC -> ATAGGTCTCCG
TATATAAATCA -> ATATAAATCAG
TATATTTAACT -> ATATTTAACTC
TATCACCAACT -> ATCACCAACTA
TATCACGGCTT -> ATCACGGCTTA
TATCATCCCTC -> ATCATCCCTCA
TATCGCATCGG -> ATCGCATCGGT
TATCGGGACGC -> ATCGGGACGCG
TATGACCGACC -> ATGACCGACCT
TATGAGAAACT -> ATGAGAAACTT
TATGAGTGTGG -> ATGAGTGTGGA
TATGCACTTAC -> ATGCACTTACC
TATGCTGGTCT -> ATGCTGGTCTA
TATTACACTAC -> ATTACACTACT
TATTACCTTCT -> ATTACCTTCTT
TATTCCAGATT -> ATTCCAGATTC
TATTCGGTTCA -> ATTCGGTTCAT
TATTGCCAAGA -> ATTGCCAAGAA
TATTGCCCTCT -> ATTGCCCTCTG
TATTGCGATTC -> ATTGCGATTCA
TATTGCTCATT -> ATTGCTCATTC
TATTGGTTCAT -> ATTGGTTCATA
TATTGTAGTGG -> ATTGTAGTGGC
TATTTAACTCT -> ATTTAACTCTC
TATTTGGGTAC -> ATTTGGGTACA
TCAAAACCACT -> CAAAACCACTG
TCAAAGTTTAG -> CAAAGTTTAGC
TCAACACAGGC -> CAACACAGGCC
TCAAGATGGCC -> CAAGATGGCCC
TCAAGTATATT -> CAAGTATATTT
TCACCAAAATA -> CACCAAAATAT
TCACCAACTAT -> CACCAACTATT
TCACCCCCGTG -> CACCCCCGTGA
TCACCGGCTTA -> CACCGGCTTAA
TCACCGGGTAT -> CACCGGGTATT
TCACCTCCATA -> CACCTCCATAC
TCACGAACGCC -> CACGAACGCCA
TCACGGCTTAA -> CACGGCTTAAG
TCACTATTGCC -> CACTATTGCCA
TCAGAAGCTTC -> CAGAAGCTTCT
TCAGCCCCGCC -> CAGCCCCGCCG
TCAGCCCCGCG -> CAGCCCCGCGT
TCAGGAATGCA -> CAGGAATGCAT
TCAGTATACTA -> CAGTATACTAA
TCAGTATTCGG -> CAGTATTCGGT
TCAGTCCGACT -> CAGTCCGACTT
TCAGTTATTGC -> CAGTTATTGCC
TCATAACTAAT -> CATAACTAATT
TCATACACCTT -> CATACACCTTT
TCATACTTAGC -> CATACTTAGCA
TCATAGGGCAT -> CATAGGGCATC
TCATAGTTGCT -> CATAGTTGCTG
TCATCCCTCAT -> CATCCCTCATC
TCATCCGAGTC -> CATCCGAGTCA
TCATCGACTAT -> CATCGACTATC
TCATGGTTGGA -> CATGGTTGGAG
TCATGTATGAC -> CATGTATGACC
TCATTCATAGT -> CATTCATAGTT
TCCACTCAGCC -> CCACTCAGCCC
TCCAGACCGTG -> CCAGACCGTGG
TCCAGATTCAC -> CCAGATTCACC
TCCATACGTCT -> CCATACGTCTA
TCCATAGCACA -> CCATAGCACAA
TCCATTCACCA -> CCATTCACCAA
TCCCAACACTG -> CCCAACACTGC
TCCCATCTGCG -> CCCATCTGCGG
TCCCATTGTAC -> CCCATTGTACA
TCCCCGCTTGC -> CCCCGCTTGCT
TCCCCTTGTAG -> CCCCTTGTAGA
TCCCGAGGAGC -> CCCGAGGAGCT
TCCCTCATCGA -> CCCTCATCGAC
TCCCTTGATAA -> CCCTTGATAAG
TCCGACTTGTT -> CCGACTTGTTG
TCCGAGTCATA -> CCGAGTCATAG
TCCGCCCACGA -> CCGCCCACGAA
TCCGGTGTCTT -> CCGGTGTCTTG
TCCGTGGGCTT -> CCGTGGGCTTG
TCCTATCATCC -> CCTATCATCCC
TCCTCACCGGG -> CCTCACCGGGT
TCCTTGGGGGA -> CCTTGGGGGAG
TCCTTGTGACG -> CCTTGTGACGT
TCGAACGTAAC -> CGAACGTAACT
TCGACTATCAC -> CGACTATCACC
TCGCATCGGTG -> CGCATCGGTGA
TCGCCCGGTAT -> CGCCCGGTATA
TCGCCGAGCCC -> CGCCGAGCCCG
TCGCCTGGTAA -> CGCCTGGTAAC
TCGCTTTAAAA -> CGCTTTAAAAA
TCGCTTTTTCA -> CGCTTTTTCAC
TCGGAATATAC -> CGGAATATACA
TCGGCAAGTTA -> CGGCAAGTTAA
TCGGCTAGATC -> CGGCTAGATCC
TCGGCTCGAAC -> CGGCTCGAACG
TCGGGACGCGA -> CGGGACGCGAG
TCGGGTGATGT -> CGGGTGATGTC
TCGGTGACGCG -> CGGTGACGCGT
TCGGTGTCAAG -> CGGTGTCAAGT
TCGGTTCATGG -> CGGTTCATGGT
TCGTCCGCCCA -> CGTCCGCCCAC
TCGTGATTCTC -> CGTGATTCTCG
TCGTGGGTGGC -> CGTGGGTGGCG
TCGTTTTGAGT -> CGTTTTGAGTC
TCGTTTTTCCC -> CGTTTTTCCCC
TCTAAAAACCG -> CTAAAAACCGA
TCTAACGGAGG -> CTAACGGAGGG
TCTAAGCATAC -> CTAAGCATACT
TCTACGTCGCT -> CTACGTCGCTT
TCTACTCGTTT -> CTACTCGTTTT
TCTAGAGATTA -> CTAGAGATTAA
TCTCACCTCCA -> CTCACCTCCAT
TCTCAGCCCCG -> CTCAGCCCCGC
TCTCCACTCAG -> CTCCACTCAGC
TCTCCATTCAC -> CTCCATTCACC
TCTCCGTGGGC -> CTCCGTGGGCT
TCTCGGCTAGA -> CTCGGCTAGAT
TCTCGTTTTTC -> CTCGTTTTTCC
TCTCTCAGCCC -> CTCTCAGCCCC
TCTGACATCCT -> CTGACATCCTC
TCTGCCAGCCG -> CTGCCAGCCGC
TCTGCCTCGGC -> CTGCCTCGGCA
TCTGCGGTGAG -> CTGCGGTGAGT
TCTGGCCCCCG -> CTGGCCCCCGG
TCTGGCGCGCG -> CTGGCGCGCGC
TCTTATGCTGG -> CTTATGCTGGT
TCTTATTTGGG -> CTTATTTGGGT
TCTTCCAGACC -> CTTCCAGACCG
TCTTCTTGACT -> CTTCTTGACTT
TCTTGACTTTG -> CTTGACTTTGC
TCTTGTCGGTG -> CTTGTCGGTGT
TGAAAGCGATA -> GAAAGCGATAT
TGAACTCAAAA -> GAACTCAAAAC
TGAAGGTAACG -> GAAGGTAACGT
TGAAGTTCGCT -> GAAGTTCGCTT
TGACATCCTCA -> GACATCCTCAC
TGACCGACCTG -> GACCGACCTGC
TGACCGTACTG -> GACCGTACTGC
TGACGCGTGGG -> GACGCGTGGGA
TGACGTACTTG -> GACGTACTTGA
TGACTAATCAT -> GACTAATCATC
TGACTTGATTG -> GACTTGATTGA
TGACTTTGCCT -> GACTTTGCCTA
TGACTTTGTGT -> GACTTTGTGTA
TGAGAAACTTG -> GAGAAACTTGT
TGAGAAAGGTG -> GAGAAAGGTGG
TGAGACAACTG -> GAGACAACTGG
TGAGCGGATCT -> GAGCGGATCTC
TGAGTCAGTTA -> GAGTCAGTTAT
TGAGTGTGGAC -> GAGTGTGGACA
TGAGTTGAGAC -> GAGTTGAGACA
TGATAAGGACT -> GATAAGGACTC
TGATACCATCA -> GATACCATCAT
TGATCGCCTGG -> GATCGCCTGGT
TGATGCCCACC -> GATGCCCACCT
TGATGGGCCTT -> GATGGGCCTTT
TGATGTCTTCC -> GATGTCTTCCA
TGATGTGGGGA -> GATGTGGGGAT
TGATTCCTATC -> GATTCCTATCA
TGATTCGGAAT -> GATTCGGAATA
TGATTCTCGTT -> GATTCTCGTTT
TGATTGATACC -> GATTGATACCA
TGCAATTAGAC -> GCAATTAGACT
TGCACCCTTGA -> GCACCCTTGAA
TGCACTCCGGT -> GCACTCCGGTG
TGCACTTACCT -> GCACTTACCTT
TGCATAGTGAC -> GCATAGTGACT
TGCATATGAGT -> GCATATGAGTG
TGCATATGCAC -> GCATATGCACT
TGCCAAGAAGA -> GCCAAGAAGAA
TGCCAGCCGCC -> GCCAGCCGCCT
TGCCCACCTTT -> GCCCACCTTTG
TGCCCGAACTA -> GCCCGAACTAT
TGCCCTCTGGC -> GCCCTCTGGCG
TGCCGAGTCGC -> GCCGAGTCGCC
TGCCGCCGAAG -> GCCGCCGAAGC
TGCCTAGAACA -> GCCTAGAACAT
TGCCTCGGCAA -> GCCTCGGCAAG
TGCCTCTTATG -> GCCTCTTATGC
TGCGATTCAAA -> GCGATTCAAAG
TGCGGTGAGTT -> GCGGTGAGTTG
TGCTAAAAGCG -> GCTAAAAGCGT
TGCTACGGCGG -> GCTACGGCGGC
TGCTCATTCAT -> GCTCATTCATA
TGCTCCATAGC -> GCTCCATAGCA
TGCTGCACTCC -> GCTGCACTCCG
TGCTGGTCTAG -> GCTGGTCTAGA
TGCTTACCAAT -> GCTTACCAATA
TGGACATTCTA -> GGACATTCTAA
TGGAGGGACGT -> GGAGGGACGTA
TGGAGGTCTGC -> GGAGGTCTGCC
TGGCACTTAGG -> GGCACTTAGGC
TGGCATGACCG -> GGCATGACCGT
TGGCCCCCGGA -> GGCCCCCGGAT
TGGCCCGGTTC -> GGCCCGGTTCC
TGGCCGAGACT -> GGCCGAGACTT
TGGCGCGCGCG -> GGCGCGCGCGG
TGGCGGCCGTT -> GGCGGCCGTTT
TGGCGGGATAC -> GGCGGGATACG
TGGGACTGATT -> GGGACTGATTC
TGGGCCTTATC -> GGGCCTTATCA
TGGGCCTTTCA -> GGGCCTTTCAG
TGGGCTTAACG -> GGGCTTAACGT
TGGGCTTGGGC -> GGGCTTGGGCC
TGGGGATGTTC -> GGGGATGTTCC
TGGGGGAGGAG -> GGGGGAGGAGT
TGGGTACATCA -> GGGTACATCAT
TGGGTGGCGGG -> GGGTGGCGGGA
TGGTAACACCC -> GGTAACACCCG
TGGTCCCATCT -> GGTCCCATCTG
TGGTCGTGGGT -> GGTCGTGGGTG
TGGTCTACTCG -> GGTCTACTCGT
TGGTCTAGAGA -> GGTCTAGAGAT
TGGTCTGCCTC -> GGTCTGCCTCG
TGGTGTGGTCT -> GGTGTGGTCTG
TGGTTCATACT -> GGTTCATACTT
TGGTTGGAGGG -> GGTTGGAGGGA
TGGTTGTATTG -> GGTTGTATTGC
TGTAACGCGAC -> GTAACGCGACC
TGTACAGGTGT -> GTACAGGTGTG
TGTAGATGAAG -> GTAGATGAAGG
TGTAGTGGCCG -> GTAGTGGCCGA
TGTATAGGTCT -> GTATAGGTCTC
TGTATGACCGA -> GTATGACCGAC
TGTATTACACT -> GTATTACACTA
TGTATTGCGAT -> GTATTGCGATT
TGTCAAGTATA -> GTCAAGTATAT
TGTCCCATTGT -> GTCCCATTGTA
TGTCGCCCGGT -> GTCGCCCGGTA
TGTCGGTGTCA -> GTCGGTGTCAA
TGTCTCCATTC -> GTCTCCATTCA
TGTCTTCCAGA -> GTCTTCCAGAC
TGTCTTGTCGG -> GTCTTGTCGGT
TGTGACGTACT -> GTGACGTACTT
TGTGGACATTC -> GTGGACATTCT
TGTGGGGATGT -> GTGGGGATGTT
TGTGGTCTGCC -> GTGGTCTGCCT
TGTGTAACGCG -> GTGTAACGCGA
TGTGTATAGGT -> GTGTATAGGTC
TGTTCCCAACA -> GTTCCCAACAC
TGTTGATCGCC -> GTTGATCGCCT
TGTTTGCATAT -> GTTTGCATATG
TTAAAAAACGA -> TAAAAAACGAG
TTAAACCCATG -> TAAACCCATGA
TTAACGTAGGG -> TAACGTAGGGT
TTAACTATCGG -> TAACTATCGGG
TTAACTCTCAC -> TAACTCTCACC
TTAACTTAGTT -> TAACTTAGTTA
TTAAGAATGGA -> TAAGAATGGAG
TTAATAAATTT -> TAATAAATTTG
TTAATACTACC -> TAATACTACCA
TTACACTACTC -> TACACTACTCC
TTACCAATAAG -> TACCAATAAGA
TTACCACGCAT -> TACCACGCATA
TTACCTTCTTC -> TACCTTCTTCT
TTACCTTGCAA -> TACCTTGCAAT
TTACTCAAGAT -> TACTCAAGATG
TTAGACTATAG -> TAGACTATAGA
TTAGCAAACAT -> TAGCAAACATC
TTAGCACAGGG -> TAGCACAGGGA
TTAGCAGAACT -> TAGCAGAACTG
TTAGCTAGCAC -> TAGCTAGCACG
TTAGGCAGCGC -> TAGGCAGCGCC
TTAGTTAGCTA -> TAGTTAGCTAG
TTATCACGGCT -> TATCACGGCTT
TTATGAGAAAC -> TATGAGAAACT
TTATGCTGGTC -> TATGCTGGTCT
TTATTGCCCTC -> TATTGCCCTCT
TTATTGTAGTG -> TATTGTAGTGG
TTATTTGGGTA -> TATTTGGGTAC
TTCAAAGTTTA -> TCAAAGTTTAG
TTCAACACAGG -> TCAACACAGGC
TTCACCAAAAT -> TCACCAAAATA
TTCACCCCCGT -> TCACCCCCGTG
TTCACTATTGC -> TCACTATTGCC
TTCAGAAGCTT -> TCAGAAGCTTC
TTCAGGAATGC -> TCAGGAATGCA
TTCAGTCCGAC -> TCAGTCCGACT
TTCATAACTAA -> TCATAACTAAT
TTCATACTTAG -> TCATACTTAGC
TTCATAGTTGC -> TCATAGTTGCT
TTCATGGTTGG -> TCATGGTTGGA
TTCCAGACCGT -> TCCAGACCGTG
TTCCAGATTCA -> TCCAGATTCAC
TTCCCAACACT -> TCCCAACACTG
TTCCCCTTGTA -> TCCCCTTGTAG
TTCCTATCATC -> TCCTATCATCC
TTCCTTGGGGG -> TCCTTGGGGGA
TTCGCTTTTTC -> TCGCTTTTTCA
TTCGGAATATA -> TCGGAATATAC
TTCGGTTCATG -> TCGGTTCATGG
TTCGTCCGCCC -> TCGTCCGCCCA
TTCTAAAAACC -> TCTAAAAACCG
TTCTAACGGAG -> TCTAACGGAGG
TTCTCGTTTTT -> TCTCGTTTTTC
TTCTGACATCC -> TCTGACATCCT
TTCTTCTTGAC -> TCTTCTTGACT
TTCTTGACTTT -> TCTTGACTTTG
TTGAAAGCGAT -> TGAAAGCGATA
TTGAAGTTCGC -> TGAAGTTCGCT
TTGACTTTGCC -> TGACTTTGCCT
TTGAGACAACT -> TGAGACAACTG
TTGAGTCAGTT -> TGAGTCAGTTA
TTGATAAGGAC -> TGATAAGGACT
TTGATACCATC -> TGATACCATCA
TTGATCGCCTG -> TGATCGCCTGG
TTGATTGATAC -> TGATTGATACC
TTGCAATTAGA -> TGCAATTAGAC
TTGCATATGCA -> TGCATATGCAC
TTGCCAAGAAG -> TGCCAAGAAGA
TTGCCCTCTGG -> TGCCCTCTGGC
TTGCCGCCGAA -> TGCCGCCGAAG
TTGCCTAGAAC -> TGCCTAGAACA
TTGCGATTCAA -> TGCGATTCAAA
TTGCTAAAAGC -> TGCTAAAAGCG
TTGCTCATTCA -> TGCTCATTCAT
TTGCTGCACTC -> TGCTGCACTCC
TTGGAGGGACG -> TGGAGGGACGT
TTGGGCCTTAT -> TGGGCCTTATC
TTGGGGGAGGA -> TGGGGGAGGAG
TTGGGTACATC -> TGGGTACATCA
TTGGTCCCATC -> TGGTCCCATCT
TTGGTCTACTC -> TGGTCTACTCG
TTGGTGTGGTC -> TGGTGTGGTCT
TTGGTTCATAC -> TGGTTCATACT
TTGGTTGTATT -> TGGTTGTATTG
TTGTACAGGTG -> TGTACAGGTGT
TTGTAGATGAA -> TGTAGATGAAG
TTGTAGTGGCC -> TGTAGTGGCCG
TTGTATTACAC -> TGTATTACACT
TTGTATTGCGA -> TGTATTGCGAT
TTGTCGCCCGG -> TGTCGCCCGGT
TTGTCGGTGTC -> TGTCGGTGTCA
TTGTGACGTAC -> TGTGACGTACT
TTGTGTAACGC -> TGTGTAACGCG
TTGTTGATCGC -> TGTTGATCGCC
TTTAAAAAACG -> TTAAAAAACGA
TTTAAACCCAT -> TTAAACCCATG
TTTAACTCTCA -> TTAACTCTCAC
TTTACCACGCA -> TTACCACGCAT
TTTACTCAAGA -> TTACTCAAGAT
TTTAGCACAGG -> TTAGCACAGGG
TTTCACTATTG -> TTCACTATTGC
TTTCAGGAATG -> TTCAGGAATGC
TTTCAGTCCGA -> TTCAGTCCGAC
TTTCCCCTTGT -> TTCCCCTTGTA
TTTCGTCCGCC -> TTCGTCCGCCC
TTTCTGACATC -> TTCTGACATCC
TTTGAGTCAGT -> TTGAGTCAGTT
TTTGCATATGC -> TTGCATATGCA
TTTGCCTAGAA -> TTGCCTAGAAC
TTTGGGTACAT -> TTGGGTACATC
TTTGGTCCCAT -> TTGGTCCCATC
TTTGGTCTACT -> TTGGTCTACTC
TTTGGTTGTAT -> TTGGTTGTATT
TTTGTGTAACG -> TTGTGTAACGC
TTTTACTCAAG -> TTTACTCAAGA
TTTTCACTATT -> TTTCACTATTG
TTTTCAGTCCG -> TTTCAGTCCGA
TTTTCCCCTTG -> TTTCCCCTTGT
TTTTGAGTCAG -> TTTGAGTCAGT
TTTTGGTTGTA -> TTTGGTTGTAT
TTTTTCACTAT -> TTTTCACTATT
TTTTTCCCCTT -> TTTTCCCCTTG
